NAME,YEAR,LSAD,CENSUS2010POP,ESTIMATESBASE2010,POPESTIMATE,NPOPCHG,BIRTHS,DEATHS,NATURALINC,INTERNATIONALMIG,DOMESTICMIG,NETMIG,RESIDUAL
,,,,,,,,,,,,,,,,,,,,,,,,,,,,,,,,,,,,,,,,,,,,,,,,,
Metropolitan Statistical Area,,,,,,,,,,,,,,,,,,,,,,,,,,,,,,,,,,,,,,,,,,,,,,,,,
,,,,,,,,,,,,,,,,,,,,,,,,,,,,,,,,,,,,,,,,,,,,,,,,,
Abilene TX 2010,2010,Metropolitan Statistical Area,165252,165252,165642,390,574,391,183,90,118,208,-1
Akron OH 2010,2010,Metropolitan Statistical Area,703200,703207,702967,-240,1830,1591,239,259,-729,-470,-9
Albany GA 2010,2010,Metropolitan Statistical Area,157308,157500,157663,163,540,410,130,19,16,35,-2
Albany OR 2010,2010,Metropolitan Statistical Area,116672,116672,116871,199,369,260,109,13,80,93,-3
Albany-Schenectady-Troy NY 2010,2010,Metropolitan Statistical Area,870716,870720,870954,234,2252,1794,458,536,-737,-201,-23
Albuquerque NM 2010,2010,Metropolitan Statistical Area,887077,887075,889649,2574,2820,1423,1397,222,917,1139,38
Alexandria LA 2010,2010,Metropolitan Statistical Area,153922,153922,154127,205,495,373,122,34,54,88,-5
Allentown-Bethlehem-Easton PA-NJ 2010,2010,Metropolitan Statistical Area,821173,821303,822083,780,2127,1961,166,496,165,661,-47
Altoona PA 2010,2010,Metropolitan Statistical Area,127089,127078,127030,-48,342,389,-47,10,-3,7,-8
Amarillo TX 2010,2010,Metropolitan Statistical Area,251933,251933,252696,763,909,586,323,134,292,426,14
Ames IA 2010,2010,Metropolitan Statistical Area,89542,89542,89596,54,221,86,135,134,-221,-87,6
Anchorage AK 2010,2010,Metropolitan Statistical Area,380821,380821,383120,2299,1450,422,1028,348,886,1234,37
Ann Arbor MI 2010,2010,Metropolitan Statistical Area,344791,345066,345525,459,945,541,404,436,-396,40,15
Anniston-Oxford-Jacksonville AL 2010,2010,Metropolitan Statistical Area,118572,118586,118443,-143,323,311,12,6,-157,-151,-4
Appleton WI 2010,2010,Metropolitan Statistical Area,225666,225666,225850,184,655,363,292,42,-149,-107,-1
Asheville NC 2010,2010,Metropolitan Statistical Area,424858,424859,425465,606,1079,1135,-56,87,560,647,15
Athens-Clarke County GA 2010,2010,Metropolitan Statistical Area,192541,192541,193476,935,623,349,274,103,524,627,34
Atlanta-Sandy Springs-Roswell GA 2010,2010,Metropolitan Statistical Area,5286728,5286727,5304207,17480,18638,7711,10927,3744,2514,6258,295
Atlantic City-Hammonton NJ 2010,2010,Metropolitan Statistical Area,274549,274549,274762,213,802,546,256,351,-384,-33,-10
Auburn-Opelika AL 2010,2010,Metropolitan Statistical Area,140247,140296,140799,503,433,237,196,132,170,302,5
Augusta-Richmond County GA-SC 2010,2010,Metropolitan Statistical Area,564873,564873,566683,1810,1912,1230,682,264,844,1108,20
Austin-Round Rock TX 2010,2010,Metropolitan Statistical Area,1716289,1716303,1727743,11440,6306,1950,4356,1167,5608,6775,309
Bakersfield CA 2010,2010,Metropolitan Statistical Area,839631,839631,841762,2131,3593,1361,2232,325,-444,-119,18
Baltimore-Columbia-Towson MD 2010,2010,Metropolitan Statistical Area,2710489,2710597,2715625,5028,8444,5531,2913,2085,144,2229,-114
Bangor ME 2010,2010,Metropolitan Statistical Area,153923,153920,153831,-89,378,374,4,22,-118,-96,3
Barnstable Town MA 2010,2010,Metropolitan Statistical Area,215888,215888,215903,15,419,707,-288,87,210,297,6
Baton Rouge LA 2010,2010,Metropolitan Statistical Area,802484,802500,804491,1991,2758,1424,1334,302,346,648,9
Battle Creek MI 2010,2010,Metropolitan Statistical Area,136146,136148,135998,-150,385,452,-67,44,-126,-82,-1
Bay City MI 2010,2010,Metropolitan Statistical Area,107771,107771,107695,-76,299,300,-1,5,-77,-72,-3
Beaumont-Port Arthur TX 2010,2010,Metropolitan Statistical Area,403190,403190,403748,558,1395,834,561,121,-97,24,-27
Beckley WV 2010,2010,Metropolitan Statistical Area,124898,124901,124902,1,382,423,-41,23,35,58,-16
Bellingham WA 2010,2010,Metropolitan Statistical Area,201140,201140,201518,378,559,358,201,73,125,198,-21
Bend-Redmond OR 2010,2010,Metropolitan Statistical Area,157733,157733,157828,95,419,372,47,4,81,85,-37
Billings MT 2010,2010,Metropolitan Statistical Area,158934,158934,159338,404,505,392,113,12,275,287,4
Binghamton NY 2010,2010,Metropolitan Statistical Area,251725,251725,251469,-256,637,556,81,113,-447,-334,-3
Birmingham-Hoover AL 2010,2010,Metropolitan Statistical Area,1128047,1128056,1129034,978,3744,2634,1110,292,-445,-153,21
Bismarck ND 2010,2010,Metropolitan Statistical Area,114778,114778,115233,455,378,275,103,5,337,342,10
Blacksburg-Christiansburg-Radford VA 2010,2010,Metropolitan Statistical Area,178237,178254,178512,258,428,273,155,151,-33,118,-15
Bloomington IL 2010,2010,Metropolitan Statistical Area,186133,186133,186421,288,551,344,207,130,-39,91,-10
Bloomington IN 2010,2010,Metropolitan Statistical Area,159549,159542,160107,565,411,307,104,190,257,447,14
Bloomsburg-Berwick PA 2010,2010,Metropolitan Statistical Area,85562,85563,85656,93,218,183,35,22,40,62,-4
Boise City ID 2010,2010,Metropolitan Statistical Area,616561,616561,617923,1362,2122,809,1313,191,-99,92,-43
Boston-Cambridge-Newton MA-NH 2010,2010,Metropolitan Statistical Area,4552402,4552412,4564659,12247,12571,7978,4593,5677,1986,7663,-9
Boston MA 2010,2010,Metropolitan Division,1887792,1887745,1893820,6075,5339,3297,2042,2562,1413,3975,58
Cambridge-Newton-Framingham MA 2010,2010,Metropolitan Division,2246244,2246301,2252330,6029,6309,3918,2391,3050,645,3695,-57
Rockingham County-Strafford County NH 2010,2010,Metropolitan Division,418366,418366,418509,143,923,763,160,65,-72,-7,-10
Boulder CO 2010,2010,Metropolitan Statistical Area,294567,294571,295967,1396,753,347,406,194,750,944,46
Bowling Green KY 2010,2010,Metropolitan Statistical Area,158599,158599,159181,582,477,212,265,95,218,313,4
Bremerton-Silverdale WA 2010,2010,Metropolitan Statistical Area,251133,251133,251650,517,697,505,192,128,206,334,-9
Bridgeport-Stamford-Norwalk CT 2010,2010,Metropolitan Statistical Area,916829,916828,919506,2678,2533,1512,1021,1227,462,1689,-32
Brownsville-Harlingen TX 2010,2010,Metropolitan Statistical Area,406220,406220,407672,1452,1868,598,1270,47,141,188,-6
Brunswick GA 2010,2010,Metropolitan Statistical Area,112370,112368,112574,206,371,250,121,25,69,94,-9
Buffalo-Cheektowaga-Niagara Falls NY 2010,2010,Metropolitan Statistical Area,1135509,1135541,1135342,-199,2914,2849,65,582,-772,-190,-74
Burlington NC 2010,2010,Metropolitan Statistical Area,151131,151241,151551,310,451,389,62,37,212,249,-1
Burlington-South Burlington VT 2010,2010,Metropolitan Statistical Area,211261,211262,211508,246,532,324,208,67,-12,55,-17
California-Lexington Park MD 2010,2010,Metropolitan Statistical Area,105151,105151,105740,589,348,200,148,65,357,422,19
Canton-Massillon OH 2010,2010,Metropolitan Statistical Area,404422,404420,404202,-218,1038,1035,3,62,-267,-205,-16
Cape Coral-Fort Myers FL 2010,2010,Metropolitan Statistical Area,618754,618754,620521,1767,1529,1468,61,577,1200,1777,-71
Cape Girardeau MO-IL 2010,2010,Metropolitan Statistical Area,96275,96275,96421,146,268,202,66,19,61,80,0
Carbondale-Marion IL 2010,2010,Metropolitan Statistical Area,126575,126580,126819,239,354,222,132,65,45,110,-3
Carson City NV 2010,2010,Metropolitan Statistical Area,55274,55274,55260,-14,146,189,-43,3,37,40,-11
Casper WY 2010,2010,Metropolitan Statistical Area,75450,75450,75466,16,258,186,72,10,-65,-55,-1
Cedar Rapids IA 2010,2010,Metropolitan Statistical Area,257940,257940,258360,420,849,449,400,62,-32,30,-10
Chambersburg-Waynesboro PA 2010,2010,Metropolitan Statistical Area,149618,149618,149908,290,474,291,183,37,75,112,-5
Champaign-Urbana IL 2010,2010,Metropolitan Statistical Area,231891,231889,232250,361,648,366,282,399,-304,95,-16
Charleston WV 2010,2010,Metropolitan Statistical Area,227078,227071,227000,-71,726,682,44,16,-106,-90,-25
Charleston-North Charleston SC 2010,2010,Metropolitan Statistical Area,664607,664643,667724,3081,2388,1155,1233,284,1489,1773,75
Charlotte-Concord-Gastonia NC-SC 2010,2010,Metropolitan Statistical Area,2217012,2217248,2223894,6646,7477,3834,3643,1187,1841,3028,-25
Charlottesville VA 2010,2010,Metropolitan Statistical Area,218705,218710,219076,366,632,478,154,195,28,223,-11
Chattanooga TN-GA 2010,2010,Metropolitan Statistical Area,528143,528145,529103,958,1468,1193,275,120,553,673,10
Cheyenne WY 2010,2010,Metropolitan Statistical Area,91738,91881,92199,318,289,234,55,46,212,258,5
Chicago-Naperville-Elgin IL-IN-WI 2010,2010,Metropolitan Statistical Area,9461105,9461537,9470069,8532,31106,16097,15009,4508,-10935,-6427,-50
Chicago-Naperville-Arlington Heights IL 2010,2010,Metropolitan Division,7262718,7263140,7269907,6767,24227,12241,11986,3952,-9074,-5122,-97
Elgin IL 2010,2010,Metropolitan Division,620429,620462,621139,677,2074,929,1145,115,-604,-489,21
Gary IN 2010,2010,Metropolitan Division,708070,708100,708305,205,2238,1642,596,63,-446,-383,-8
Lake County-Kenosha County IL-WI 2010,2010,Metropolitan Division,869888,869835,870718,883,2567,1285,1282,378,-811,-433,34
Chico CA 2010,2010,Metropolitan Statistical Area,220000,220000,219924,-76,576,526,50,57,-180,-123,-3
Cincinnati OH-KY-IN 2010,2010,Metropolitan Statistical Area,2114580,2114755,2117863,3108,6755,3989,2766,731,-339,392,-50
Clarksville TN-KY 2010,2010,Metropolitan Statistical Area,260625,260610,261814,1204,1304,467,837,289,55,344,23
Cleveland TN 2010,2010,Metropolitan Statistical Area,115788,115788,115965,177,332,245,87,20,73,93,-3
Cleveland-Elyria OH 2010,2010,Metropolitan Statistical Area,2077240,2077246,2075558,-1688,5797,5130,667,714,-3116,-2402,47
Coeur d'Alene ID 2010,2010,Metropolitan Statistical Area,138494,138494,138890,396,398,252,146,15,225,240,10
College Station-Bryan TX 2010,2010,Metropolitan Statistical Area,228660,228660,229478,818,766,326,440,326,63,389,-11
Colorado Springs CO 2010,2010,Metropolitan Statistical Area,645613,645611,650351,4740,2308,878,1430,427,2710,3137,173
Columbia MO 2010,2010,Metropolitan Statistical Area,162642,162642,163182,540,481,296,185,146,199,345,10
Columbia SC 2010,2010,Metropolitan Statistical Area,767598,767477,769661,2184,2419,1565,854,421,889,1310,20
Columbus GA-AL 2010,2010,Metropolitan Statistical Area,294865,295529,296454,925,1145,562,583,267,60,327,15
Columbus IN 2010,2010,Metropolitan Statistical Area,76794,76786,76848,62,250,206,44,64,-41,23,-5
Columbus OH 2010,2010,Metropolitan Statistical Area,1901974,1902015,1906177,4162,6478,3331,3147,1046,-2,1044,-29
Corpus Christi TX 2010,2010,Metropolitan Statistical Area,428185,428188,428026,-162,1455,983,472,166,-822,-656,22
Corvallis OR 2010,2010,Metropolitan Statistical Area,85579,85581,85531,-50,163,100,63,86,-209,-123,10
Crestview-Fort Walton Beach-Destin FL 2010,2010,Metropolitan Statistical Area,235865,235865,236006,141,750,469,281,228,-405,-177,37
Cumberland MD-WV 2010,2010,Metropolitan Statistical Area,103299,103299,103236,-63,253,286,-33,9,-33,-24,-6
Dallas-Fort Worth-Arlington TX 2010,2010,Metropolitan Statistical Area,6426214,6426210,6452725,26515,23955,8955,15000,4208,6981,11189,326
Dallas-Plano-Irving TX 2010,2010,Metropolitan Division,4230520,4230013,4248448,18435,15795,5614,10181,3233,4708,7941,313
Fort Worth-Arlington TX 2010,2010,Metropolitan Division,2195694,2196197,2204277,8080,8160,3341,4819,975,2273,3248,13
Dalton GA 2010,2010,Metropolitan Statistical Area,142227,142227,142317,90,491,229,262,11,-182,-171,-1
Danville IL 2010,2010,Metropolitan Statistical Area,81625,81625,81595,-30,259,164,95,6,-124,-118,-7
Daphne-Fairhope-Foley AL 2010,2010,Metropolitan Statistical Area,182265,182265,183216,951,548,537,11,67,851,918,22
Davenport-Moline-Rock Island IA-IL 2010,2010,Metropolitan Statistical Area,379690,379689,380241,552,1192,774,418,92,36,128,6
Dayton OH 2010,2010,Metropolitan Statistical Area,799232,799216,800245,1029,2394,1776,618,351,196,547,-136
Decatur AL 2010,2010,Metropolitan Statistical Area,153829,153825,153863,38,417,353,64,22,-32,-10,-16
Decatur IL 2010,2010,Metropolitan Statistical Area,110768,110768,110757,-11,334,248,86,23,-121,-98,1
Deltona-Daytona Beach-Ormond Beach FL 2010,2010,Metropolitan Statistical Area,590289,590293,590678,385,1390,1776,-386,212,598,810,-39
Denver-Aurora-Lakewood CO 2010,2010,Metropolitan Statistical Area,2543482,2543594,2554335,10741,8534,3888,4646,944,4919,5863,232
Des Moines-West Des Moines IA 2010,2010,Metropolitan Statistical Area,569633,569633,571883,2250,2048,989,1059,291,855,1146,45
Detroit-Warren-Dearborn MI 2010,2010,Metropolitan Statistical Area,4296250,4296313,4291176,-5137,12684,9528,3156,2023,-10763,-8740,447
Detroit-Dearborn-Livonia MI 2010,2010,Metropolitan Division,1820584,1820641,1815497,-5144,6244,4556,1688,732,-7859,-7127,295
Warren-Troy-Farmington Hills MI 2010,2010,Metropolitan Division,2475666,2475672,2475679,7,6440,4972,1468,1291,-2904,-1613,152
Dothan AL 2010,2010,Metropolitan Statistical Area,145639,145639,145867,228,436,411,25,7,198,205,-2
Dover DE 2010,2010,Metropolitan Statistical Area,162310,162344,162954,610,538,333,205,96,299,395,10
Dubuque IA 2010,2010,Metropolitan Statistical Area,93653,93653,93893,240,285,165,120,12,108,120,0
Duluth MN-WI 2010,2010,Metropolitan Statistical Area,279771,279771,279789,18,766,686,80,41,-95,-54,-8
Durham-Chapel Hill NC 2010,2010,Metropolitan Statistical Area,504357,506634,508063,1429,1632,848,784,513,135,648,-3
East Stroudsburg PA 2010,2010,Metropolitan Statistical Area,169842,169842,169940,98,408,345,63,40,-3,37,-2
Eau Claire WI 2010,2010,Metropolitan Statistical Area,161151,161390,161633,243,430,228,202,14,36,50,-9
El Centro CA 2010,2010,Metropolitan Statistical Area,174528,174528,174779,251,731,180,551,-15,-295,-310,10
Elizabethtown-Fort Knox KY 2010,2010,Metropolitan Statistical Area,148338,148339,149897,1558,499,358,141,170,1185,1355,62
Elkhart-Goshen IN 2010,2010,Metropolitan Statistical Area,197559,197561,197441,-120,709,319,390,28,-567,-539,29
Elmira NY 2010,2010,Metropolitan Statistical Area,88830,88830,88947,117,241,197,44,19,59,78,-5
El Paso TX 2010,2010,Metropolitan Statistical Area,804123,804123,807089,2966,3310,1134,2176,295,489,784,6
Erie PA 2010,2010,Metropolitan Statistical Area,280566,280566,280720,154,787,546,241,74,-141,-67,-20
Eugene OR 2010,2010,Metropolitan Statistical Area,351715,351715,351852,137,841,731,110,150,-110,40,-13
Evansville IN-KY 2010,2010,Metropolitan Statistical Area,311552,311552,311778,226,962,835,127,45,65,110,-11
Fairbanks AK 2010,2010,Metropolitan Statistical Area,97581,97581,98174,593,371,116,255,115,206,321,17
Fargo ND-MN 2010,2010,Metropolitan Statistical Area,208777,208777,209423,646,747,373,374,139,133,272,0
Farmington NM 2010,2010,Metropolitan Statistical Area,130044,130045,130155,110,476,200,276,6,-171,-165,-1
Fayetteville NC 2010,2010,Metropolitan Statistical Area,366383,366383,367727,1344,1732,594,1138,516,-365,151,55
Fayetteville-Springdale-Rogers AR-MO 2010,2010,Metropolitan Statistical Area,463204,463207,465699,2492,1662,726,936,303,1204,1507,49
Flagstaff AZ 2010,2010,Metropolitan Statistical Area,134421,134437,134603,166,451,163,288,33,-145,-112,-10
Flint MI 2010,2010,Metropolitan Statistical Area,425790,425790,424976,-814,1242,1104,138,62,-1064,-1002,50
Florence SC 2010,2010,Metropolitan Statistical Area,205566,205571,205713,142,642,483,159,31,-44,-13,-4
Florence-Muscle Shoals AL 2010,2010,Metropolitan Statistical Area,147137,147137,147231,94,373,356,17,25,57,82,-5
Fond du Lac WI 2010,2010,Metropolitan Statistical Area,101633,101633,101645,12,240,250,-10,14,27,41,-19
Fort Collins CO 2010,2010,Metropolitan Statistical Area,299630,299630,300484,854,814,488,326,63,477,540,-12
Fort Smith AR-OK 2010,2010,Metropolitan Statistical Area,280467,280515,280729,214,823,621,202,43,-18,25,-13
Fort Wayne IN 2010,2010,Metropolitan Statistical Area,416257,416255,416850,595,1505,688,817,189,-399,-210,-12
Fresno CA 2010,2010,Metropolitan Statistical Area,930450,930452,932642,2190,4086,1584,2502,326,-645,-319,7
Gadsden AL 2010,2010,Metropolitan Statistical Area,104430,104427,104501,74,320,288,32,11,40,51,-9
Gainesville FL 2010,2010,Metropolitan Statistical Area,264275,264274,264667,393,793,377,416,290,-333,-43,20
Gainesville GA 2010,2010,Metropolitan Statistical Area,179684,179684,180034,350,667,221,446,72,-163,-91,-5
Gettysburg PA 2010,2010,Metropolitan Statistical Area,101407,101413,101470,57,273,202,71,9,-22,-13,-1
Glens Falls NY 2010,2010,Metropolitan Statistical Area,128923,128921,128991,70,313,299,14,7,58,65,-9
Goldsboro NC 2010,2010,Metropolitan Statistical Area,122623,122623,122888,265,399,224,175,86,9,95,-5
Grand Forks ND-MN 2010,2010,Metropolitan Statistical Area,98461,98461,98605,144,335,195,140,62,-47,15,-11
Grand Island NE 2010,2010,Metropolitan Statistical Area,81850,81850,82043,193,275,156,119,75,7,82,-8
Grand Junction CO 2010,2010,Metropolitan Statistical Area,146723,146723,146485,-238,481,333,148,16,-415,-399,13
Grand Rapids-Wyoming MI 2010,2010,Metropolitan Statistical Area,988938,988940,989205,265,3211,1733,1478,299,-1565,-1266,53
Grants Pass OR 2010,2010,Metropolitan Statistical Area,82713,82713,82835,122,185,234,-49,4,165,169,2
Great Falls MT 2010,2010,Metropolitan Statistical Area,81327,81327,81506,179,284,231,53,58,65,123,3
Greeley CO 2010,2010,Metropolitan Statistical Area,252825,252837,254173,1336,955,366,589,44,656,700,47
Green Bay WI 2010,2010,Metropolitan Statistical Area,306241,306241,306712,471,999,518,481,80,-73,7,-17
Greensboro-High Point NC 2010,2010,Metropolitan Statistical Area,723801,723798,725040,1242,2083,1310,773,342,161,503,-34
Greenville NC 2010,2010,Metropolitan Statistical Area,168148,168148,168826,678,552,215,337,44,282,326,15
Greenville-Anderson-Mauldin SC 2010,2010,Metropolitan Statistical Area,824112,824107,825765,1658,2554,1651,903,322,422,744,11
Gulfport-Biloxi-Pascagoula MS 2010,2010,Metropolitan Statistical Area,370702,370787,371524,737,1261,924,337,212,171,383,17
Hagerstown-Martinsburg MD-WV 2010,2010,Metropolitan Statistical Area,251599,251602,252408,806,778,592,186,78,513,591,29
Hammond LA 2010,2010,Metropolitan Statistical Area,121097,121101,121572,471,475,198,277,25,160,185,9
Hanford-Corcoran CA 2010,2010,Metropolitan Statistical Area,152982,152982,152418,-564,627,227,400,98,-1135,-1037,73
Harrisburg-Carlisle PA 2010,2010,Metropolitan Statistical Area,549475,549473,550258,785,1609,1165,444,316,43,359,-18
Harrisonburg VA 2010,2010,Metropolitan Statistical Area,125228,125217,125426,209,359,214,145,96,-18,78,-14
Hartford-West Hartford-East Hartford CT 2010,2010,Metropolitan Statistical Area,1212381,1212387,1214021,1634,3027,2447,580,1060,53,1113,-59
Hattiesburg MS 2010,2010,Metropolitan Statistical Area,142842,142857,143336,479,513,297,216,30,235,265,-2
Hickory-Lenoir-Morganton NC 2010,2010,Metropolitan Statistical Area,365497,365492,365305,-187,1036,870,166,70,-398,-328,-25
Hilton Head Island-Bluffton-Beaufort SC 2010,2010,Metropolitan Statistical Area,187010,187010,187898,888,655,432,223,200,467,667,-2
Hinesville GA 2010,2010,Metropolitan Statistical Area,77917,77917,77365,-552,404,115,289,114,-1036,-922,81
Homosassa Springs FL 2010,2010,Metropolitan Statistical Area,141236,141236,141283,47,262,597,-335,21,362,383,-1
Hot Springs AR 2010,2010,Metropolitan Statistical Area,96024,96024,96156,132,298,369,-71,9,196,205,-2
Houma-Thibodaux LA 2010,2010,Metropolitan Statistical Area,208178,208176,208221,45,687,393,294,57,-303,-246,-3
Houston-The Woodlands-Sugar Land TX 2010,2010,Metropolitan Statistical Area,5920416,5920490,5949076,28586,23211,8322,14889,5995,7491,13486,211
Huntington-Ashland WV-KY-OH 2010,2010,Metropolitan Statistical Area,364908,364930,365170,240,1045,924,121,42,99,141,-22
Huntsville AL 2010,2010,Metropolitan Statistical Area,417593,417593,419418,1825,1309,758,551,159,1054,1213,61
Idaho Falls ID 2010,2010,Metropolitan Statistical Area,133265,133337,133791,454,632,180,452,9,-1,8,-6
Indianapolis-Carmel-Anderson IN 2010,2010,Metropolitan Statistical Area,1887877,1888082,1892508,4426,6556,3609,2947,940,485,1425,54
Iowa City IA 2010,2010,Metropolitan Statistical Area,152586,152586,152963,377,507,230,277,170,-65,105,-5
Ithaca NY 2010,2010,Metropolitan Statistical Area,101564,101595,101726,131,193,122,71,226,-167,59,1
Jackson MI 2010,2010,Metropolitan Statistical Area,160248,160248,160149,-99,463,421,42,25,-170,-145,4
Jackson MS 2010,2010,Metropolitan Statistical Area,567122,567645,568905,1260,1926,941,985,133,187,320,-45
Jackson TN 2010,2010,Metropolitan Statistical Area,130011,130009,130043,34,427,314,113,8,-78,-70,-9
Jacksonville FL 2010,2010,Metropolitan Statistical Area,1345596,1345596,1349137,3541,4313,2608,1705,854,981,1835,1
Jacksonville NC 2010,2010,Metropolitan Statistical Area,177772,177772,179563,1791,1003,158,845,529,375,904,42
Janesville-Beloit WI 2010,2010,Metropolitan Statistical Area,160331,160331,160230,-101,486,309,177,8,-285,-277,-1
Jefferson City MO 2010,2010,Metropolitan Statistical Area,149807,149807,149950,143,436,286,150,26,-21,5,-12
Johnson City TN 2010,2010,Metropolitan Statistical Area,198716,198716,198976,260,517,478,39,15,215,230,-9
Johnstown PA 2010,2010,Metropolitan Statistical Area,143679,143674,143444,-230,352,489,-137,12,-95,-83,-10
Jonesboro AR 2010,2010,Metropolitan Statistical Area,121026,121026,121270,244,420,287,133,26,81,107,4
Joplin MO 2010,2010,Metropolitan Statistical Area,175518,175516,175922,406,653,414,239,36,142,178,-11
Kahului-Wailuku-Lahaina HI 2010,2010,Metropolitan Statistical Area,154924,154925,155072,147,488,264,224,153,-236,-83,6
Kalamazoo-Portage MI 2010,2010,Metropolitan Statistical Area,326589,326596,326920,324,1029,630,399,137,-209,-72,-3
Kankakee IL 2010,2010,Metropolitan Statistical Area,113449,113449,113462,13,384,299,85,16,-91,-75,3
Kansas City MO-KS 2010,2010,Metropolitan Statistical Area,2009342,2009338,2013651,4313,7031,3803,3228,720,431,1151,-66
Kennewick-Richland WA 2010,2010,Metropolitan Statistical Area,253340,253340,255578,2238,1017,378,639,55,1466,1521,78
Killeen-Temple TX 2010,2010,Metropolitan Statistical Area,405300,405298,408217,2919,1769,500,1269,641,931,1572,78
Kingsport-Bristol-Bristol TN-VA 2010,2010,Metropolitan Statistical Area,309544,309542,309584,42,805,863,-58,20,99,119,-19
Kingston NY 2010,2010,Metropolitan Statistical Area,182493,182494,182374,-120,407,416,-9,81,-188,-107,-4
Knoxville TN 2010,2010,Metropolitan Statistical Area,837571,837579,838687,1108,2262,1933,329,170,627,797,-18
Kokomo IN 2010,2010,Metropolitan Statistical Area,82752,82752,82766,14,260,173,87,17,-87,-70,-3
La Crosse-Onalaska WI-MN 2010,2010,Metropolitan Statistical Area,133665,133665,133856,191,373,261,112,30,58,88,-9
Lafayette LA 2010,2010,Metropolitan Statistical Area,466750,466750,467650,900,1624,743,881,161,-115,46,-27
Lafayette-West Lafayette IN 2010,2010,Metropolitan Statistical Area,201789,201789,202055,266,625,278,347,281,-369,-88,7
Lake Charles LA 2010,2010,Metropolitan Statistical Area,199607,199629,200069,440,682,517,165,48,240,288,-13
Lake Havasu City-Kingman AZ 2010,2010,Metropolitan Statistical Area,200186,200186,200380,194,517,570,-53,-6,264,258,-11
Lakeland-Winter Haven FL 2010,2010,Metropolitan Statistical Area,602095,602095,603359,1264,1931,1302,629,471,155,626,9
Lancaster PA 2010,2010,Metropolitan Statistical Area,519445,519448,520317,869,1683,1021,662,227,10,237,-30
Lansing-East Lansing MI 2010,2010,Metropolitan Statistical Area,464036,464032,464158,126,1223,764,459,436,-797,-361,28
Laredo TX 2010,2010,Metropolitan Statistical Area,250304,250304,251308,1004,1304,307,997,54,-44,10,-3
Las Cruces NM 2010,2010,Metropolitan Statistical Area,209233,209241,210237,996,790,397,393,-14,592,578,25
Las Vegas-Henderson-Paradise NV 2010,2010,Metropolitan Statistical Area,1951269,1951269,1953263,1994,6522,3286,3236,1321,-2617,-1296,54
Lawrence KS 2010,2010,Metropolitan Statistical Area,110826,110826,111296,470,346,119,227,133,103,236,7
Lawton OK 2010,2010,Metropolitan Statistical Area,130291,130291,131625,1334,573,217,356,175,752,927,51
Lebanon PA 2010,2010,Metropolitan Statistical Area,133568,133573,133728,155,424,381,43,54,72,126,-14
Lewiston ID-WA 2010,2010,Metropolitan Statistical Area,60888,60888,61018,130,152,129,23,11,95,106,1
Lewiston-Auburn ME 2010,2010,Metropolitan Statistical Area,107702,107702,107661,-41,325,251,74,21,-140,-119,4
Lexington-Fayette KY 2010,2010,Metropolitan Statistical Area,472099,472099,473402,1303,1471,835,636,255,407,662,5
Lima OH 2010,2010,Metropolitan Statistical Area,106331,106331,106364,33,300,218,82,15,-63,-48,-1
Lincoln NE 2010,2010,Metropolitan Statistical Area,302157,302157,302922,765,1036,437,599,185,-10,175,-9
Little Rock-North Little Rock-Conway AR 2010,2010,Metropolitan Statistical Area,699757,699799,702305,2506,2344,1555,789,254,1407,1661,56
Logan UT-ID 2010,2010,Metropolitan Statistical Area,125442,125442,126076,634,619,121,498,69,62,131,5
Longview TX 2010,2010,Metropolitan Statistical Area,214369,214378,214732,354,755,411,344,62,-42,20,-10
Longview WA 2010,2010,Metropolitan Statistical Area,102410,102410,102392,-18,274,296,-22,0,18,18,-14
Los Angeles-Long Beach-Anaheim CA 2010,2010,Metropolitan Statistical Area,12828837,12828933,12845311,16378,42693,18112,24581,12234,-20886,-8652,449
Anaheim-Santa Ana-Irvine CA 2010,2010,Metropolitan Division,3010232,3010269,3018080,7811,9572,4319,5253,2351,306,2657,-99
Los Angeles-Long Beach-Glendale CA 2010,2010,Metropolitan Division,9818605,9818664,9827231,8567,33121,13793,19328,9883,-21192,-11309,548
Louisville/Jefferson County KY-IN 2010,2010,Metropolitan Statistical Area,1235708,1235710,1237778,2068,3947,2768,1179,475,463,938,-49
Lubbock TX 2010,2010,Metropolitan Statistical Area,290805,290805,292152,1347,1077,541,536,92,676,768,43
Lynchburg VA 2010,2010,Metropolitan Statistical Area,252634,252656,253024,368,719,651,68,83,236,319,-19
Macon GA 2010,2010,Metropolitan Statistical Area,232293,232293,232307,14,837,609,228,41,-252,-211,-3
Madera CA 2010,2010,Metropolitan Statistical Area,150865,150865,151154,289,599,325,274,14,0,14,1
Madison WI 2010,2010,Metropolitan Statistical Area,605435,605437,606409,972,1780,1024,756,330,-75,255,-39
Manchester-Nashua NH 2010,2010,Metropolitan Statistical Area,400721,400721,400982,261,1102,632,470,228,-439,-211,2
Manhattan KS 2010,2010,Metropolitan Statistical Area,92719,92735,93344,609,395,104,291,192,122,314,4
Mankato-North Mankato MN 2010,2010,Metropolitan Statistical Area,96740,96740,96809,69,273,143,130,29,-90,-61,0
Mansfield OH 2010,2010,Metropolitan Statistical Area,124475,124475,124175,-300,312,329,-17,5,-300,-295,12
McAllen-Edinburg-Mission TX 2010,2010,Metropolitan Statistical Area,774769,774773,779194,4421,3833,908,2925,177,1274,1451,45
Medford OR 2010,2010,Metropolitan Statistical Area,203206,203206,203421,215,587,542,45,31,156,187,-17
Memphis TN-MS-AR 2010,2010,Metropolitan Statistical Area,1324829,1324829,1326580,1751,4721,2543,2178,363,-788,-425,-2
Merced CA 2010,2010,Metropolitan Statistical Area,255793,255798,256731,933,973,433,540,72,317,389,4
Miami-Fort Lauderdale-West Palm Beach FL 2010,2010,Metropolitan Statistical Area,5564635,5566299,5586506,20207,16638,11329,5309,13978,948,14926,-28
Fort Lauderdale-Pompano Beach-Deerfield Beach FL 2010,2010,Metropolitan Division,1748066,1748148,1753576,5428,5401,3739,1662,3400,426,3826,-60
Miami-Miami Beach-Kendall FL 2010,2010,Metropolitan Division,2496435,2498017,2508689,10672,7818,4335,3483,8946,-1768,7178,11
West Palm Beach-Boca Raton-Delray Beach FL 2010,2010,Metropolitan Division,1320134,1320134,1324241,4107,3419,3255,164,1632,2290,3922,21
Michigan City-La Porte IN 2010,2010,Metropolitan Statistical Area,111467,111467,111421,-46,303,227,76,4,-129,-125,3
Midland MI 2010,2010,Metropolitan Statistical Area,83629,83629,83664,35,223,139,84,32,-84,-52,3
Midland TX 2010,2010,Metropolitan Statistical Area,141671,141674,141798,124,567,246,321,25,-218,-193,-4
Milwaukee-Waukesha-West Allis WI 2010,2010,Metropolitan Statistical Area,1555908,1555954,1556535,581,4954,3193,1761,438,-1590,-1152,-28
Minneapolis-St. Paul-Bloomington MN-WI 2010,2010,Metropolitan Statistical Area,3348859,3348857,3355105,6248,11242,5020,6222,2294,-2318,-24,50
Missoula MT 2010,2010,Metropolitan Statistical Area,109299,109299,109425,126,293,214,79,24,22,46,1
Mobile AL 2010,2010,Metropolitan Statistical Area,412992,413143,413432,289,1453,951,502,154,-363,-209,-4
Modesto CA 2010,2010,Metropolitan Statistical Area,514453,514451,515283,832,1892,920,972,218,-365,-147,7
Monroe LA 2010,2010,Metropolitan Statistical Area,176441,176502,176785,283,560,311,249,42,-8,34,0
Monroe MI 2010,2010,Metropolitan Statistical Area,152021,152021,151911,-110,396,354,42,16,-178,-162,10
Montgomery AL 2010,2010,Metropolitan Statistical Area,374536,374529,375208,679,1220,815,405,156,114,270,4
Morgantown WV 2010,2010,Metropolitan Statistical Area,129709,129709,130328,619,296,166,130,63,399,462,27
Morristown TN 2010,2010,Metropolitan Statistical Area,113951,114111,114217,106,357,313,44,11,62,73,-11
Mount Vernon-Anacortes WA 2010,2010,Metropolitan Statistical Area,116901,116901,116967,66,340,299,41,26,9,35,-10
Muncie IN 2010,2010,Metropolitan Statistical Area,117671,117671,117672,1,303,264,39,32,-66,-34,-4
Muskegon MI 2010,2010,Metropolitan Statistical Area,172188,172188,171916,-272,544,395,149,12,-460,-448,27
Myrtle Beach-Conway-North Myrtle Beach SC-NC 2010,2010,Metropolitan Statistical Area,376722,376722,378644,1922,1017,827,190,106,1570,1676,56
Napa CA 2010,2010,Metropolitan Statistical Area,136484,136530,136829,299,398,312,86,80,138,218,-5
Naples-Immokalee-Marco Island FL 2010,2010,Metropolitan Statistical Area,321520,321520,322710,1190,813,748,65,480,730,1210,-85
Nashville-Davidson--Murfreesboro--Franklin TN 2010,2010,Metropolitan Statistical Area,1670890,1670900,1675913,5013,5610,2998,2612,813,1557,2370,31
New Bern NC 2010,2010,Metropolitan Statistical Area,126802,126802,127105,303,438,303,135,137,36,173,-5
New Haven-Milford CT 2010,2010,Metropolitan Statistical Area,862477,862474,863367,893,2247,1712,535,686,-243,443,-85
New Orleans-Metairie LA 2010,2010,Metropolitan Statistical Area,1189866,1189863,1195794,5931,3771,2343,1428,770,3485,4255,248
New York-Newark-Jersey City NY-NJ-PA 2010,2010,Metropolitan Statistical Area,19567410,19566440,19599534,33094,62552,33030,29522,30436,-25933,4503,-931
Dutchess County-Putnam County NY 2010,2010,Metropolitan Division,397198,397198,397462,264,939,746,193,250,-165,85,-14
Nassau County-Suffolk County NY 2010,2010,Metropolitan Division,2832882,2833056,2836244,3188,7530,5312,2218,1992,-853,1139,-169
Newark NJ-PA 2010,2010,Metropolitan Division,2471171,2469792,2472739,2947,7121,4381,2740,3124,-2866,258,-51
New York-Jersey City-White Plains NY-NJ 2010,2010,Metropolitan Division,13866159,13866394,13893089,26695,46962,22591,24371,25070,-22049,3021,-697
Niles-Benton Harbor MI 2010,2010,Metropolitan Statistical Area,156813,156817,156803,-14,497,427,70,65,-146,-81,-3
North Port-Sarasota-Bradenton FL 2010,2010,Metropolitan Statistical Area,702281,702270,703462,1192,1571,2036,-465,353,1314,1667,-10
Norwich-New London CT 2010,2010,Metropolitan Statistical Area,274055,274046,274102,56,703,545,158,321,-434,-113,11
Ocala FL 2010,2010,Metropolitan Statistical Area,331298,331303,331527,224,868,996,-128,131,235,366,-14
Ocean City NJ 2010,2010,Metropolitan Statistical Area,97265,97265,97278,13,240,349,-109,52,78,130,-8
Odessa TX 2010,2010,Metropolitan Statistical Area,137130,137133,137098,-35,598,214,384,-13,-415,-428,9
Ogden-Clearfield UT 2010,2010,Metropolitan Statistical Area,597159,597159,599569,2410,2693,825,1868,165,385,550,-8
Oklahoma City OK 2010,2010,Metropolitan Statistical Area,1252987,1252992,1257888,4896,4715,2557,2158,572,2116,2688,50
Olympia-Tumwater WA 2010,2010,Metropolitan Statistical Area,252264,252264,253046,782,745,477,268,160,357,517,-3
Omaha-Council Bluffs NE-IA 2010,2010,Metropolitan Statistical Area,865350,865350,868113,2763,3280,1526,1754,421,589,1010,-1
Orlando-Kissimmee-Sanford FL 2010,2010,Metropolitan Statistical Area,2134411,2134406,2139686,5280,6497,3581,2916,2912,-580,2332,32
Oshkosh-Neenah WI 2010,2010,Metropolitan Statistical Area,166994,166994,167004,10,451,363,88,20,-89,-69,-9
Owensboro KY 2010,2010,Metropolitan Statistical Area,114752,114755,114791,36,377,331,46,2,-5,-3,-7
Oxnard-Thousand Oaks-Ventura CA 2010,2010,Metropolitan Statistical Area,823318,823420,825353,1933,2804,1268,1536,312,102,414,-17
Palm Bay-Melbourne-Titusville FL 2010,2010,Metropolitan Statistical Area,543376,543378,544029,651,1230,1360,-130,253,518,771,10
Panama City FL 2010,2010,Metropolitan Statistical Area,184715,184715,185111,396,597,423,174,95,117,212,10
Parkersburg-Vienna WV 2010,2010,Metropolitan Statistical Area,92673,92673,92715,42,240,300,-60,0,112,112,-10
Pensacola-Ferry Pass-Brent FL 2010,2010,Metropolitan Statistical Area,448991,448991,450980,1989,1331,1034,297,334,1268,1602,90
Peoria IL 2010,2010,Metropolitan Statistical Area,379186,379186,378954,-232,1188,838,350,93,-680,-587,5
Philadelphia-Camden-Wilmington PA-NJ-DE-MD 2010,2010,Metropolitan Statistical Area,5965343,5965368,5971276,5908,18312,12716,5596,3807,-3331,476,-164
Camden NJ 2010,2010,Metropolitan Division,1250679,1250694,1251406,712,3599,2558,1041,664,-998,-334,5
Montgomery County-Bucks County-Chester County PA 2010,2010,Metropolitan Division,1924009,1924274,1926275,2001,5089,3860,1229,854,-42,812,-40
Philadelphia PA 2010,2010,Metropolitan Division,2084985,2084732,2087570,2838,7454,4837,2617,1929,-1585,344,-123
Wilmington DE-MD-NJ 2010,2010,Metropolitan Division,705670,705668,706025,357,2170,1461,709,360,-706,-346,-6
Phoenix-Mesa-Scottsdale AZ 2010,2010,Metropolitan Statistical Area,4192887,4193127,4209347,16220,15202,6948,8254,1645,5918,7563,403
Pine Bluff AR 2010,2010,Metropolitan Statistical Area,100258,100258,100076,-182,301,277,24,1,-214,-213,7
Pittsburgh PA 2010,2010,Metropolitan Statistical Area,2356285,2356285,2356678,393,5757,6137,-380,622,334,956,-183
Pittsfield MA 2010,2010,Metropolitan Statistical Area,131219,131272,131310,38,299,290,9,35,9,44,-15
Pocatello ID 2010,2010,Metropolitan Statistical Area,82839,82839,83000,161,332,117,215,13,-67,-54,0
Portland-South Portland ME 2010,2010,Metropolitan Statistical Area,514098,514100,513807,-293,1247,1019,228,142,-684,-542,21
Portland-Vancouver-Hillsboro OR-WA 2010,2010,Metropolitan Statistical Area,2226009,2226011,2232079,6068,6799,3683,3116,1081,1900,2981,-29
Port St. Lucie FL 2010,2010,Metropolitan Statistical Area,424107,424107,425246,1139,1025,1071,-46,252,930,1182,3
Prescott AZ 2010,2010,Metropolitan Statistical Area,211033,211015,210517,-498,477,641,-164,32,-349,-317,-17
Providence-Warwick RI-MA 2010,2010,Metropolitan Statistical Area,1600852,1601216,1602154,938,4136,3427,709,961,-759,202,27
Provo-Orem UT 2010,2010,Metropolitan Statistical Area,526810,526810,529830,3020,2957,473,2484,145,380,525,11
Pueblo CO 2010,2010,Metropolitan Statistical Area,159063,159063,159536,473,526,418,108,15,335,350,15
Punta Gorda FL 2010,2010,Metropolitan Statistical Area,159978,159989,159927,-62,242,584,-342,59,254,313,-33
Racine WI 2010,2010,Metropolitan Statistical Area,195408,195428,195446,18,612,456,156,30,-172,-142,4
Raleigh NC 2010,2010,Metropolitan Statistical Area,1130490,1130490,1137346,6856,3933,1460,2473,809,3414,4223,160
Rapid City SD 2010,2010,Metropolitan Statistical Area,134598,134609,135052,443,490,269,221,52,180,232,-10
Reading PA 2010,2010,Metropolitan Statistical Area,411442,411587,411905,318,1126,842,284,227,-169,58,-24
Redding CA 2010,2010,Metropolitan Statistical Area,177223,177223,177286,63,504,464,40,43,-10,33,-10
Reno NV 2010,2010,Metropolitan Statistical Area,425417,425437,426032,595,1330,919,411,126,92,218,-34
Richmond VA 2010,2010,Metropolitan Statistical Area,1208101,1208080,1210063,1983,3642,2420,1222,876,-33,843,-82
Riverside-San Bernardino-Ontario CA 2010,2010,Metropolitan Statistical Area,4224851,4224972,4244242,19270,15119,6439,8680,1256,8972,10228,362
Roanoke VA 2010,2010,Metropolitan Statistical Area,308707,308693,308781,88,895,810,85,165,-162,3,0
Rochester MN 2010,2010,Metropolitan Statistical Area,206877,206877,207140,263,719,300,419,143,-297,-154,-2
Rochester NY 2010,2010,Metropolitan Statistical Area,1079671,1079692,1080082,390,2868,2319,549,517,-658,-141,-18
Rockford IL 2010,2010,Metropolitan Statistical Area,349431,349431,349295,-136,1110,626,484,80,-719,-639,19
Rocky Mount NC 2010,2010,Metropolitan Statistical Area,152392,152388,152484,96,505,374,131,20,-37,-17,-18
Rome GA 2010,2010,Metropolitan Statistical Area,96317,96317,96393,76,304,202,102,29,-44,-15,-11
Sacramento--Roseville--Arden-Arcade CA 2010,2010,Metropolitan Statistical Area,2149127,2149143,2154382,5239,6833,3721,3112,1310,905,2215,-88
Saginaw MI 2010,2010,Metropolitan Statistical Area,200169,200169,199882,-287,557,546,11,38,-354,-316,18
St. Cloud MN 2010,2010,Metropolitan Statistical Area,189093,189093,189188,95,608,321,287,54,-253,-199,7
St. George UT 2010,2010,Metropolitan Statistical Area,138115,138115,138406,291,590,298,292,16,10,26,-27
St. Joseph MO-KS 2010,2010,Metropolitan Statistical Area,127329,127329,127278,-51,433,295,138,35,-224,-189,0
St. Louis MO-IL 2010,2010,Metropolitan Statistical Area,2787701,2787747,2789886,2139,8550,5736,2814,921,-1524,-603,-72
Salem OR 2010,2010,Metropolitan Statistical Area,390738,390738,391487,749,1383,811,572,66,125,191,-14
Salinas CA 2010,2010,Metropolitan Statistical Area,415057,415057,416364,1307,1634,521,1113,200,20,220,-26
Salisbury MD-DE 2010,2010,Metropolitan Statistical Area,373802,373769,374762,993,1057,842,215,231,531,762,16
Salt Lake City UT 2010,2010,Metropolitan Statistical Area,1087873,1087873,1091432,3559,4720,1516,3204,536,-156,380,-25
San Angelo TX 2010,2010,Metropolitan Statistical Area,111823,111823,112283,460,405,204,201,62,189,251,8
San Antonio-New Braunfels TX 2010,2010,Metropolitan Statistical Area,2142508,2142518,2153255,10737,7519,3532,3987,943,5533,6476,274
San Diego-Carlsbad CA 2010,2010,Metropolitan Statistical Area,3095313,3095308,3104543,9235,10949,4678,6271,3130,-114,3016,-52
San Francisco-Oakland-Hayward CA 2010,2010,Metropolitan Statistical Area,4335391,4335560,4345179,9619,12738,6738,6000,5490,-1864,3626,-7
Oakland-Hayward-Berkeley CA 2010,2010,Metropolitan Division,2559296,2559458,2566519,7061,7751,3880,3871,2943,177,3120,70
San Francisco-Redwood City-South San Francisco CA 2010,2010,Metropolitan Division,1523686,1523693,1525776,2083,4415,2383,2032,2366,-2240,126,-75
San Rafael CA 2010,2010,Metropolitan Division,252409,252409,252884,475,572,475,97,181,199,380,-2
San Jose-Sunnyvale-Santa Clara CA 2010,2010,Metropolitan Statistical Area,1836911,1836941,1842462,5521,6151,2207,3944,3395,-1866,1529,48
San Luis Obispo-Paso Robles-Arroyo Grande CA 2010,2010,Metropolitan Statistical Area,269637,269593,269860,267,666,515,151,36,99,135,-19
Santa Cruz-Watsonville CA 2010,2010,Metropolitan Statistical Area,262382,262362,263213,851,763,437,326,47,446,493,32
Santa Fe NM 2010,2010,Metropolitan Statistical Area,144170,144171,144503,332,392,215,177,91,65,156,-1
Santa Maria-Santa Barbara CA 2010,2010,Metropolitan Statistical Area,423895,423939,424331,392,1473,764,709,256,-602,-346,29
Santa Rosa CA 2010,2010,Metropolitan Statistical Area,483878,483880,484666,786,1305,948,357,103,341,444,-15
Savannah GA 2010,2010,Metropolitan Statistical Area,347611,347621,348843,1222,1211,587,624,201,387,588,10
Scranton--Wilkes-Barre--Hazleton PA 2010,2010,Metropolitan Statistical Area,563631,563630,563655,25,1407,1587,-180,247,16,263,-58
Seattle-Tacoma-Bellevue WA 2010,2010,Metropolitan Statistical Area,3439809,3439815,3448234,8419,10992,5167,5825,3539,-911,2628,-34
Seattle-Bellevue-Everett WA 2010,2010,Metropolitan Division,2644584,2644586,2652786,8200,8286,3814,4472,3058,776,3834,-106
Tacoma-Lakewood WA 2010,2010,Metropolitan Division,795225,795229,795448,219,2706,1353,1353,481,-1687,-1206,72
Sebastian-Vero Beach FL 2010,2010,Metropolitan Statistical Area,138028,138028,138235,207,319,408,-89,45,250,295,1
Sebring FL 2010,2010,Metropolitan Statistical Area,98786,98786,98703,-83,257,414,-157,32,51,83,-9
Sheboygan WI 2010,2010,Metropolitan Statistical Area,115507,115507,115418,-89,312,226,86,25,-195,-170,-5
Sherman-Denison TX 2010,2010,Metropolitan Statistical Area,120877,120877,121086,209,372,292,80,28,103,131,-2
Shreveport-Bossier City LA 2010,2010,Metropolitan Statistical Area,439811,439811,441161,1350,1549,1006,543,142,645,787,20
Sierra Vista-Douglas AZ 2010,2010,Metropolitan Statistical Area,131346,131357,131868,511,455,265,190,116,199,315,6
Sioux City IA-NE-SD 2010,2010,Metropolitan Statistical Area,168563,168563,168793,230,627,406,221,56,-44,12,-3
Sioux Falls SD 2010,2010,Metropolitan Statistical Area,228261,228264,229099,835,915,466,449,141,254,395,-9
South Bend-Mishawaka IN-MI 2010,2010,Metropolitan Statistical Area,319224,319215,318981,-234,982,707,275,106,-611,-505,-4
Spartanburg SC 2010,2010,Metropolitan Statistical Area,313268,313268,313676,408,976,650,326,61,32,93,-11
Spokane-Spokane Valley WA 2010,2010,Metropolitan Statistical Area,527753,527753,528493,740,1551,1093,458,180,138,318,-36
Springfield IL 2010,2010,Metropolitan Statistical Area,210170,210170,210526,356,691,540,151,35,168,203,2
Springfield MA 2010,2010,Metropolitan Statistical Area,621570,621705,623426,1721,1626,1338,288,600,783,1383,50
Springfield MO 2010,2010,Metropolitan Statistical Area,436712,436712,437444,732,1426,992,434,64,240,304,-6
Springfield OH 2010,2010,Metropolitan Statistical Area,138333,138333,138227,-106,419,376,43,12,-156,-144,-5
State College PA 2010,2010,Metropolitan Statistical Area,153990,153981,154182,201,323,216,107,171,-76,95,-1
Staunton-Waynesboro VA 2010,2010,Metropolitan Statistical Area,118502,118502,118378,-124,326,353,-27,12,-72,-60,-37
Stockton-Lodi CA 2010,2010,Metropolitan Statistical Area,685306,685308,687513,2205,2635,1091,1544,309,380,689,-28
Sumter SC 2010,2010,Metropolitan Statistical Area,107456,107463,107581,118,375,192,183,59,-120,-61,-4
Syracuse NY 2010,2010,Metropolitan Statistical Area,662577,662578,662976,398,1863,1265,598,355,-509,-154,-46
Tallahassee FL 2010,2010,Metropolitan Statistical Area,367413,368770,369475,705,1103,510,593,178,-58,120,-8
Tampa-St. Petersburg-Clearwater FL 2010,2010,Metropolitan Statistical Area,2783243,2783514,2789334,5820,7837,6689,1148,2112,2533,4645,27
Terre Haute IN 2010,2010,Metropolitan Statistical Area,172425,172422,172314,-108,504,561,-57,44,-91,-47,-4
Texarkana TX-AR 2010,2010,Metropolitan Statistical Area,149198,149195,149315,120,471,415,56,13,55,68,-4
The Villages FL 2010,2010,Metropolitan Statistical Area,93420,93420,94287,867,110,282,-172,2,1090,1092,-53
Toledo OH 2010,2010,Metropolitan Statistical Area,610001,610001,610201,200,1981,1363,618,160,-635,-475,57
Topeka KS 2010,2010,Metropolitan Statistical Area,233870,233868,234209,341,751,477,274,31,60,91,-24
Trenton NJ 2010,2010,Metropolitan Statistical Area,366513,367508,368043,535,1142,721,421,567,-464,103,11
Tucson AZ 2010,2010,Metropolitan Statistical Area,980263,980263,981935,1672,3135,1998,1137,380,275,655,-120
Tulsa OK 2010,2010,Metropolitan Statistical Area,937478,937528,939858,2330,3315,2092,1223,230,917,1147,-40
Tuscaloosa AL 2010,2010,Metropolitan Statistical Area,230162,230159,230489,330,732,380,352,71,-79,-8,-14
Tyler TX 2010,2010,Metropolitan Statistical Area,209714,209714,210455,741,720,432,288,47,405,452,1
Urban Honolulu HI 2010,2010,Metropolitan Statistical Area,953207,953207,956336,3129,3349,1753,1596,1601,-62,1539,-6
Utica-Rome NY 2010,2010,Metropolitan Statistical Area,299397,299382,299301,-81,817,818,-1,161,-229,-68,-12
Valdosta GA 2010,2010,Metropolitan Statistical Area,139588,139665,140104,439,529,342,187,61,170,231,21
Vallejo-Fairfield CA 2010,2010,Metropolitan Statistical Area,413344,413344,414101,757,1241,637,604,329,-154,175,-22
Victoria TX 2010,2010,Metropolitan Statistical Area,94003,94003,94070,67,324,167,157,26,-106,-80,-10
Vineland-Bridgeton NJ 2010,2010,Metropolitan Statistical Area,156898,156898,157200,302,613,375,238,91,-24,67,-3
Virginia Beach-Norfolk-Newport News VA-NC 2010,2010,Metropolitan Statistical Area,1676822,1676817,1680110,3293,5747,3091,2656,1511,-950,561,76
Visalia-Porterville CA 2010,2010,Metropolitan Statistical Area,442179,442182,443292,1110,2080,642,1438,-19,-313,-332,4
Waco TX 2010,2010,Metropolitan Statistical Area,252772,252772,253837,1065,920,431,489,52,502,554,22
Walla Walla WA 2010,2010,Metropolitan Statistical Area,62859,62859,63029,170,167,142,25,23,127,150,-5
Warner Robins GA 2010,2010,Metropolitan Statistical Area,179605,179605,180412,807,604,297,307,91,391,482,18
Washington-Arlington-Alexandria DC-VA-MD-WV 2010,2010,Metropolitan Statistical Area,5636232,5636406,5665931,29525,19585,7695,11890,9132,8130,17262,373
Silver Spring-Frederick-Rockville MD 2010,2010,Metropolitan Division,1205162,1205191,1210106,4915,3884,1852,2032,2232,659,2891,-8
Washington-Arlington-Alexandria DC-VA-MD-WV 2010,2010,Metropolitan Division,4431070,4431215,4455825,24610,15701,5843,9858,6900,7471,14371,381
Waterloo-Cedar Falls IA 2010,2010,Metropolitan Statistical Area,167819,167819,167888,69,495,407,88,27,-34,-7,-12
Watertown-Fort Drum NY 2010,2010,Metropolitan Statistical Area,116229,116229,116595,366,513,244,269,159,-39,120,-23
Wausau WI 2010,2010,Metropolitan Statistical Area,134063,134063,134065,2,404,299,105,21,-130,-109,6
Weirton-Steubenville WV-OH 2010,2010,Metropolitan Statistical Area,124454,124454,124266,-188,279,397,-118,2,-54,-52,-18
Wenatchee WA 2010,2010,Metropolitan Statistical Area,110884,110887,111261,374,379,212,167,17,198,215,-8
Wheeling WV-OH 2010,2010,Metropolitan Statistical Area,147950,147950,147829,-121,358,454,-96,7,-18,-11,-14
Wichita KS 2010,2010,Metropolitan Statistical Area,630919,630919,631936,1017,2444,1321,1123,220,-307,-87,-19
Wichita Falls TX 2010,2010,Metropolitan Statistical Area,151306,151476,151628,152,479,300,179,142,-168,-26,-1
Williamsport PA 2010,2010,Metropolitan Statistical Area,116111,116108,116173,65,301,249,52,11,12,23,-10
Wilmington NC 2010,2010,Metropolitan Statistical Area,254884,254884,255734,850,745,391,354,56,432,488,8
Winchester VA-WV 2010,2010,Metropolitan Statistical Area,128472,128473,128726,253,413,284,129,29,91,120,4
Winston-Salem NC 2010,2010,Metropolitan Statistical Area,640595,640577,641351,774,1880,1354,526,213,54,267,-19
Worcester MA-CT 2010,2010,Metropolitan Statistical Area,916980,916976,918791,1815,2426,1732,694,637,490,1127,-6
Yakima WA 2010,2010,Metropolitan Statistical Area,243231,243231,244146,915,1025,424,601,-24,336,312,2
York-Hanover PA 2010,2010,Metropolitan Statistical Area,434972,435002,435543,541,1261,951,310,101,151,252,-21
Youngstown-Warren-Boardman OH-PA 2010,2010,Metropolitan Statistical Area,565773,565804,564874,-930,1421,1738,-317,55,-669,-614,1
Yuba City CA 2010,2010,Metropolitan Statistical Area,166892,166892,167204,312,657,313,344,164,-196,-32,0
Yuma AZ 2010,2010,Metropolitan Statistical Area,195751,195750,197105,1355,777,265,512,53,724,777,66
Abilene TX 2011,2011,Metropolitan Statistical Area,,,166637,995,2293,1501,792,193,8,201,2
Akron OH 2011,2011,Metropolitan Statistical Area,,,702881,-86,7577,6662,915,1022,-1752,-730,-271
Albany GA 2011,2011,Metropolitan Statistical Area,,,157791,128,2336,1241,1095,79,-1136,-1057,90
Albany OR 2011,2011,Metropolitan Statistical Area,,,118117,1246,1450,1127,323,43,876,919,4
Albany-Schenectady-Troy NY 2011,2011,Metropolitan Statistical Area,,,872966,2012,9103,7625,1478,2154,-1543,611,-77
Albuquerque NM 2011,2011,Metropolitan Statistical Area,,,897091,7442,11173,6712,4461,1005,2149,3154,-173
Alexandria LA 2011,2011,Metropolitan Statistical Area,,,154419,292,2037,1480,557,148,-329,-181,-84
Allentown-Bethlehem-Easton PA-NJ 2011,2011,Metropolitan Statistical Area,,,825229,3146,8716,7862,854,2367,9,2376,-84
Altoona PA 2011,2011,Metropolitan Statistical Area,,,127175,145,1386,1595,-209,33,263,296,58
Amarillo TX 2011,2011,Metropolitan Statistical Area,,,255988,3292,3787,2151,1636,629,1050,1679,-23
Ames IA 2011,2011,Metropolitan Statistical Area,,,90896,1300,991,494,497,625,207,832,-29
Anchorage AK 2011,2011,Metropolitan Statistical Area,,,388140,5020,6118,2012,4106,879,61,940,-26
Ann Arbor MI 2011,2011,Metropolitan Statistical Area,,,349150,3625,3824,2052,1772,1899,48,1947,-94
Anniston-Oxford-Jacksonville AL 2011,2011,Metropolitan Statistical Area,,,117760,-683,1385,1327,58,27,-726,-699,-42
Appleton WI 2011,2011,Metropolitan Statistical Area,,,227411,1561,2937,1531,1406,184,12,196,-41
Asheville NC 2011,2011,Metropolitan Statistical Area,,,428436,2971,4350,4517,-167,362,2701,3063,75
Athens-Clarke County GA 2011,2011,Metropolitan Statistical Area,,,194658,1182,2246,1260,986,456,-306,150,46
Atlanta-Sandy Springs-Roswell GA 2011,2011,Metropolitan Statistical Area,,,5374825,70618,73837,32040,41797,17490,9338,26828,1993
Atlantic City-Hammonton NJ 2011,2011,Metropolitan Statistical Area,,,274923,161,3412,2566,846,1416,-2002,-586,-99
Auburn-Opelika AL 2011,2011,Metropolitan Statistical Area,,,144146,3347,1630,804,826,551,1918,2469,52
Augusta-Richmond County GA-SC 2011,2011,Metropolitan Statistical Area,,,571047,4364,7399,4950,2449,673,1130,1803,112
Austin-Round Rock TX 2011,2011,Metropolitan Statistical Area,,,1782089,54346,25239,8291,16948,5972,29719,35691,1707
Bakersfield CA 2011,2011,Metropolitan Statistical Area,,,849872,8110,14407,5410,8997,1740,-2383,-643,-244
Baltimore-Columbia-Towson MD 2011,2011,Metropolitan Statistical Area,,,2735205,19580,33973,22598,11375,8538,-53,8485,-280
Bangor ME 2011,2011,Metropolitan Statistical Area,,,153799,-32,1448,1437,11,125,-161,-36,-7
Barnstable Town MA 2011,2011,Metropolitan Statistical Area,,,215335,-568,1650,2871,-1221,279,560,839,-186
Baton Rouge LA 2011,2011,Metropolitan Statistical Area,,,808657,4166,10942,6159,4783,1215,-1846,-631,14
Battle Creek MI 2011,2011,Metropolitan Statistical Area,,,135282,-716,1662,1467,195,175,-1092,-917,6
Bay City MI 2011,2011,Metropolitan Statistical Area,,,107477,-218,1152,1152,0,40,-264,-224,6
Beaumont-Port Arthur TX 2011,2011,Metropolitan Statistical Area,,,405275,1527,5228,3891,1337,547,-224,323,-133
Beckley WV 2011,2011,Metropolitan Statistical Area,,,125187,285,1549,1627,-78,87,303,390,-27
Bellingham WA 2011,2011,Metropolitan Statistical Area,,,203329,1811,2284,1430,854,271,721,992,-35
Bend-Redmond OR 2011,2011,Metropolitan Statistical Area,,,159786,1958,1710,1220,490,-15,1354,1339,129
Billings MT 2011,2011,Metropolitan Statistical Area,,,160761,1423,2084,1470,614,40,758,798,11
Binghamton NY 2011,2011,Metropolitan Statistical Area,,,250251,-1218,2524,2576,-52,441,-1472,-1031,-135
Birmingham-Hoover AL 2011,2011,Metropolitan Statistical Area,,,1131010,1976,14798,11218,3580,1162,-2714,-1552,-52
Bismarck ND 2011,2011,Metropolitan Statistical Area,,,117393,2160,1591,961,630,20,1372,1392,138
Blacksburg-Christiansburg-Radford VA 2011,2011,Metropolitan Statistical Area,,,178911,399,1618,1478,140,675,-437,238,21
Bloomington IL 2011,2011,Metropolitan Statistical Area,,,187282,861,2338,1285,1053,529,-649,-120,-72
Bloomington IN 2011,2011,Metropolitan Statistical Area,,,161855,1748,1464,1069,395,859,518,1377,-24
Bloomsburg-Berwick PA 2011,2011,Metropolitan Statistical Area,,,85309,-347,833,878,-45,156,-486,-330,28
Boise City ID 2011,2011,Metropolitan Statistical Area,,,627627,9704,8645,4118,4527,762,3977,4739,438
Boston-Cambridge-Newton MA-NH 2011,2011,Metropolitan Statistical Area,,,4608848,44189,51997,34811,17186,27209,1347,28556,-1553
Boston MA 2011,2011,Metropolitan Division,,,1913683,19863,21993,14351,7642,12459,230,12689,-468
Cambridge-Newton-Framingham MA 2011,2011,Metropolitan Division,,,2275221,22891,26118,17328,8790,14487,652,15139,-1038
Rockingham County-Strafford County NH 2011,2011,Metropolitan Division,,,419944,1435,3886,3132,754,263,465,728,-47
Boulder CO 2011,2011,Metropolitan Statistical Area,,,300650,4683,2996,1505,1491,802,2345,3147,45
Bowling Green KY 2011,2011,Metropolitan Statistical Area,,,160504,1323,1946,1401,545,456,331,787,-9
Bremerton-Silverdale WA 2011,2011,Metropolitan Statistical Area,,,254372,2722,2962,2029,933,186,1594,1780,9
Bridgeport-Stamford-Norwalk CT 2011,2011,Metropolitan Statistical Area,,,928722,9216,10408,6474,3934,5890,-289,5601,-319
Brownsville-Harlingen TX 2011,2011,Metropolitan Statistical Area,,,413188,5516,7814,2322,5492,786,-539,247,-223
Brunswick GA 2011,2011,Metropolitan Statistical Area,,,113034,460,1347,1081,266,115,60,175,19
Buffalo-Cheektowaga-Niagara Falls NY 2011,2011,Metropolitan Statistical Area,,,1135411,69,11937,12122,-185,2902,-2031,871,-617
Burlington NC 2011,2011,Metropolitan Statistical Area,,,152866,1315,1761,1456,305,143,884,1027,-17
Burlington-South Burlington VT 2011,2011,Metropolitan Statistical Area,,,212837,1329,2144,1403,741,411,198,609,-21
California-Lexington Park MD 2011,2011,Metropolitan Statistical Area,,,107757,2017,1485,646,839,126,959,1085,93
Canton-Massillon OH 2011,2011,Metropolitan Statistical Area,,,403119,-1083,4400,4404,-4,206,-1117,-911,-168
Cape Coral-Fort Myers FL 2011,2011,Metropolitan Statistical Area,,,631412,10891,6266,6070,196,2847,7240,10087,608
Cape Girardeau MO-IL 2011,2011,Metropolitan Statistical Area,,,97027,606,1153,1033,120,108,322,430,56
Carbondale-Marion IL 2011,2011,Metropolitan Statistical Area,,,127107,288,1466,1244,222,287,-223,64,2
Carson City NV 2011,2011,Metropolitan Statistical Area,,,54747,-513,585,632,-47,-4,-438,-442,-24
Casper WY 2011,2011,Metropolitan Statistical Area,,,76416,950,1029,664,365,38,546,584,1
Cedar Rapids IA 2011,2011,Metropolitan Statistical Area,,,260862,2502,3134,2032,1102,302,1102,1404,-4
Chambersburg-Waynesboro PA 2011,2011,Metropolitan Statistical Area,,,151004,1096,1892,1392,500,201,402,603,-7
Champaign-Urbana IL 2011,2011,Metropolitan Statistical Area,,,233332,1082,2624,1614,1010,1747,-1643,104,-32
Charleston WV 2011,2011,Metropolitan Statistical Area,,,225879,-1121,2523,2926,-403,56,-790,-734,16
Charleston-North Charleston SC 2011,2011,Metropolitan Statistical Area,,,681482,13758,9032,4887,4145,647,8192,8839,774
Charlotte-Concord-Gastonia NC-SC 2011,2011,Metropolitan Statistical Area,,,2257149,33255,29293,16338,12955,5324,14413,19737,563
Charlottesville VA 2011,2011,Metropolitan Statistical Area,,,221339,2263,2376,1641,735,807,472,1279,249
Chattanooga TN-GA 2011,2011,Metropolitan Statistical Area,,,533162,4059,6058,4906,1152,524,2389,2913,-6
Cheyenne WY 2011,2011,Metropolitan Statistical Area,,,92607,408,1289,769,520,38,-110,-72,-40
Chicago-Naperville-Elgin IL-IN-WI 2011,2011,Metropolitan Statistical Area,,,9493464,23395,123700,66706,56994,24319,-57441,-33122,-477
Chicago-Naperville-Arlington Heights IL 2011,2011,Metropolitan Division,,,7293395,23488,96712,51617,45095,21778,-42371,-20593,-1014
Elgin IL 2011,2011,Metropolitan Division,,,624443,3304,8374,3469,4905,825,-2864,-2039,438
Gary IN 2011,2011,Metropolitan Division,,,707793,-512,8408,6264,2144,327,-2882,-2555,-101
Lake County-Kenosha County IL-WI 2011,2011,Metropolitan Division,,,867833,-2885,10206,5356,4850,1389,-9324,-7935,200
Chico CA 2011,2011,Metropolitan Statistical Area,,,220025,101,2439,2179,260,230,-267,-37,-122
Cincinnati OH-KY-IN 2011,2011,Metropolitan Statistical Area,,,2123332,5469,27567,18100,9467,3276,-7113,-3837,-161
Clarksville TN-KY 2011,2011,Metropolitan Statistical Area,,,264611,2797,4631,1783,2848,479,-563,-84,33
Cleveland TN 2011,2011,Metropolitan Statistical Area,,,116657,692,1240,1169,71,111,525,636,-15
Cleveland-Elyria OH 2011,2011,Metropolitan Statistical Area,,,2068399,-7159,23602,21073,2529,3619,-13160,-9541,-147
Coeur d'Alene ID 2011,2011,Metropolitan Statistical Area,,,141045,2155,1733,1237,496,36,1545,1581,78
College Station-Bryan TX 2011,2011,Metropolitan Statistical Area,,,231578,2100,3008,1203,1805,1400,-1130,270,25
Colorado Springs CO 2011,2011,Metropolitan Statistical Area,,,660278,9927,9455,3807,5648,892,3450,4342,-63
Columbia MO 2011,2011,Metropolitan Statistical Area,,,165922,2740,2069,942,1127,586,1042,1628,-15
Columbia SC 2011,2011,Metropolitan Statistical Area,,,776630,6969,9462,5965,3497,1302,2215,3517,-45
Columbus GA-AL 2011,2011,Metropolitan Statistical Area,,,302513,6059,4466,2684,1782,446,3757,4203,74
Columbus IN 2011,2011,Metropolitan Statistical Area,,,77621,773,981,712,269,236,287,523,-19
Columbus OH 2011,2011,Metropolitan Statistical Area,,,1925540,19363,26309,14212,12097,4843,2607,7450,-184
Corpus Christi TX 2011,2011,Metropolitan Statistical Area,,,431051,3025,5817,3542,2275,646,59,705,45
Corvallis OR 2011,2011,Metropolitan Statistical Area,,,85983,452,764,551,213,337,-105,232,7
Crestview-Fort Walton Beach-Destin FL 2011,2011,Metropolitan Statistical Area,,,238954,2948,3234,2076,1158,390,1389,1779,11
Cumberland MD-WV 2011,2011,Metropolitan Statistical Area,,,102620,-616,981,1220,-239,41,-364,-323,-54
Dallas-Fort Worth-Arlington TX 2011,2011,Metropolitan Statistical Area,,,6574866,122141,96343,37741,58602,23167,39153,62320,1219
Dallas-Plano-Irving TX 2011,2011,Metropolitan Division,,,4336015,87567,64249,23328,40921,17335,28542,45877,769
Fort Worth-Arlington TX 2011,2011,Metropolitan Division,,,2238851,34574,32094,14413,17681,5832,10611,16443,450
Dalton GA 2011,2011,Metropolitan Statistical Area,,,142504,187,1968,1072,896,106,-780,-674,-35
Danville IL 2011,2011,Metropolitan Statistical Area,,,81358,-237,1090,1029,61,23,-282,-259,-39
Daphne-Fairhope-Foley AL 2011,2011,Metropolitan Statistical Area,,,186694,3478,2187,1819,368,247,2692,2939,171
Davenport-Moline-Rock Island IA-IL 2011,2011,Metropolitan Statistical Area,,,380926,685,4576,3666,910,451,-552,-101,-124
Dayton OH 2011,2011,Metropolitan Statistical Area,,,801334,1089,9438,7961,1477,1233,-1400,-167,-221
Decatur AL 2011,2011,Metropolitan Statistical Area,,,153914,51,1847,1659,188,98,-197,-99,-38
Decatur IL 2011,2011,Metropolitan Statistical Area,,,110582,-175,1389,1172,217,74,-406,-332,-60
Deltona-Daytona Beach-Ormond Beach FL 2011,2011,Metropolitan Statistical Area,,,591753,1075,5400,7185,-1785,1118,1827,2945,-85
Denver-Aurora-Lakewood CO 2011,2011,Metropolitan Statistical Area,,,2600843,46508,34785,15255,19530,5496,20237,25733,1245
Des Moines-West Des Moines IA 2011,2011,Metropolitan Statistical Area,,,580741,8858,8261,4130,4131,1380,3199,4579,148
Detroit-Warren-Dearborn MI 2011,2011,Metropolitan Statistical Area,,,4287145,-4031,50157,39640,10517,9972,-24968,-14996,448
Detroit-Dearborn-Livonia MI 2011,2011,Metropolitan Division,,,1801614,-13883,23817,17989,5828,3664,-24160,-20496,785
Warren-Troy-Farmington Hills MI 2011,2011,Metropolitan Division,,,2485531,9852,26340,21651,4689,6308,-808,5500,-337
Dothan AL 2011,2011,Metropolitan Statistical Area,,,146655,788,1840,1473,367,60,362,422,-1
Dover DE 2011,2011,Metropolitan Statistical Area,,,165214,2260,2197,1375,822,310,1041,1351,87
Dubuque IA 2011,2011,Metropolitan Statistical Area,,,94507,614,1160,867,293,71,287,358,-37
Duluth MN-WI 2011,2011,Metropolitan Statistical Area,,,279907,118,2903,2911,-8,195,71,266,-140
Durham-Chapel Hill NC 2011,2011,Metropolitan Statistical Area,,,515828,7765,6539,3599,2940,2058,2000,4058,767
East Stroudsburg PA 2011,2011,Metropolitan Statistical Area,,,169860,-80,1452,1264,188,179,-392,-213,-55
Eau Claire WI 2011,2011,Metropolitan Statistical Area,,,162838,1205,1893,1241,652,85,516,601,-48
El Centro CA 2011,2011,Metropolitan Statistical Area,,,176300,1521,3127,980,2147,298,-935,-637,11
Elizabethtown-Fort Knox KY 2011,2011,Metropolitan Statistical Area,,,151295,1398,2199,1257,942,188,265,453,3
Elkhart-Goshen IN 2011,2011,Metropolitan Statistical Area,,,198480,1039,3053,1515,1538,126,-616,-490,-9
Elmira NY 2011,2011,Metropolitan Statistical Area,,,88973,26,1025,970,55,71,-39,32,-61
El Paso TX 2011,2011,Metropolitan Statistical Area,,,823134,16045,13867,4785,9082,1829,5382,7211,-248
Erie PA 2011,2011,Metropolitan Statistical Area,,,280938,218,3285,2808,477,379,-466,-87,-172
Eugene OR 2011,2011,Metropolitan Statistical Area,,,353491,1639,3470,3128,342,614,764,1378,-81
Evansville IN-KY 2011,2011,Metropolitan Statistical Area,,,312589,811,3773,3066,707,196,17,213,-109
Fairbanks AK 2011,2011,Metropolitan Statistical Area,,,98029,-145,1775,447,1328,150,-1702,-1552,79
Fargo ND-MN 2011,2011,Metropolitan Statistical Area,,,212835,3412,2993,1351,1642,620,1068,1688,82
Farmington NM 2011,2011,Metropolitan Statistical Area,,,128035,-2120,1928,887,1041,11,-3202,-3191,30
Fayetteville NC 2011,2011,Metropolitan Statistical Area,,,373329,5602,6955,2579,4376,726,574,1300,-74
Fayetteville-Springdale-Rogers AR-MO 2011,2011,Metropolitan Statistical Area,,,474222,8523,6928,3294,3634,1322,3368,4690,199
Flagstaff AZ 2011,2011,Metropolitan Statistical Area,,,134159,-444,1801,720,1081,110,-1658,-1548,23
Flint MI 2011,2011,Metropolitan Statistical Area,,,421716,-3260,5217,4150,1067,223,-4464,-4241,-86
Florence SC 2011,2011,Metropolitan Statistical Area,,,205746,33,2616,2273,343,116,-327,-211,-99
Florence-Muscle Shoals AL 2011,2011,Metropolitan Statistical Area,,,147042,-189,1555,1768,-213,90,2,92,-68
Fond du Lac WI 2011,2011,Metropolitan Statistical Area,,,101792,147,1096,916,180,78,-60,18,-51
Fort Collins CO 2011,2011,Metropolitan Statistical Area,,,305241,4757,3317,1867,1450,350,2744,3094,213
Fort Smith AR-OK 2011,2011,Metropolitan Statistical Area,,,281012,283,3162,2657,505,136,-321,-185,-37
Fort Wayne IN 2011,2011,Metropolitan Statistical Area,,,419757,2907,5982,3422,2560,773,-271,502,-155
Fresno CA 2011,2011,Metropolitan Statistical Area,,,941260,8618,16321,6000,10321,1999,-3503,-1504,-199
Gadsden AL 2011,2011,Metropolitan Statistical Area,,,104310,-191,1250,1355,-105,56,-105,-49,-37
Gainesville FL 2011,2011,Metropolitan Statistical Area,,,266691,2024,3003,1928,1075,1253,-205,1048,-99
Gainesville GA 2011,2011,Metropolitan Statistical Area,,,182954,2920,2614,1193,1421,298,900,1198,301
Gettysburg PA 2011,2011,Metropolitan Statistical Area,,,101649,179,1052,923,129,50,-84,-34,84
Glens Falls NY 2011,2011,Metropolitan Statistical Area,,,128782,-209,1255,1261,-6,41,-195,-154,-49
Goldsboro NC 2011,2011,Metropolitan Statistical Area,,,124022,1134,1662,1145,517,196,475,671,-54
Grand Forks ND-MN 2011,2011,Metropolitan Statistical Area,,,98195,-410,1334,839,495,268,-1173,-905,0
Grand Island NE 2011,2011,Metropolitan Statistical Area,,,82683,640,1170,792,378,333,-63,270,-8
Grand Junction CO 2011,2011,Metropolitan Statistical Area,,,147380,895,1908,1305,603,64,276,340,-48
Grand Rapids-Wyoming MI 2011,2011,Metropolitan Statistical Area,,,996355,7150,13329,6985,6344,1418,-212,1206,-400
Grants Pass OR 2011,2011,Metropolitan Statistical Area,,,82618,-217,780,1213,-433,7,251,258,-42
Great Falls MT 2011,2011,Metropolitan Statistical Area,,,81747,241,1196,820,376,64,-148,-84,-51
Greeley CO 2011,2011,Metropolitan Statistical Area,,,258737,4564,3753,1443,2310,277,1840,2117,137
Green Bay WI 2011,2011,Metropolitan Statistical Area,,,308763,2051,3911,2325,1586,382,157,539,-74
Greensboro-High Point NC 2011,2011,Metropolitan Statistical Area,,,730077,5037,8627,6170,2457,1490,1280,2770,-190
Greenville NC 2011,2011,Metropolitan Statistical Area,,,170763,1937,2094,1143,951,211,805,1016,-30
Greenville-Anderson-Mauldin SC 2011,2011,Metropolitan Statistical Area,,,833417,7652,10359,7499,2860,1381,3443,4824,-32
Gulfport-Biloxi-Pascagoula MS 2011,2011,Metropolitan Statistical Area,,,375762,4238,4873,3356,1517,449,2082,2531,190
Hagerstown-Martinsburg MD-WV 2011,2011,Metropolitan Statistical Area,,,254533,2125,3022,2246,776,274,1072,1346,3
Hammond LA 2011,2011,Metropolitan Statistical Area,,,122727,1155,1849,1073,776,107,309,416,-37
Hanford-Corcoran CA 2011,2011,Metropolitan Statistical Area,,,152063,-355,2579,746,1833,250,-2470,-2220,32
Harrisburg-Carlisle PA 2011,2011,Metropolitan Statistical Area,,,551935,1677,6588,5070,1518,1321,-881,440,-281
Harrisonburg VA 2011,2011,Metropolitan Statistical Area,,,126920,1494,1427,906,521,421,265,686,287
Hartford-West Hartford-East Hartford CT 2011,2011,Metropolitan Statistical Area,,,1216393,2372,12447,10397,2050,5250,-4582,668,-346
Hattiesburg MS 2011,2011,Metropolitan Statistical Area,,,145298,1962,2080,1212,868,93,870,963,131
Hickory-Lenoir-Morganton NC 2011,2011,Metropolitan Statistical Area,,,364392,-913,3757,3760,-3,271,-1219,-948,38
Hilton Head Island-Bluffton-Beaufort SC 2011,2011,Metropolitan Statistical Area,,,189524,1626,2401,1522,879,444,91,535,212
Hinesville GA 2011,2011,Metropolitan Statistical Area,,,80358,2993,1369,375,994,179,1731,1910,89
Homosassa Springs FL 2011,2011,Metropolitan Statistical Area,,,139773,-1510,1059,2278,-1219,77,-235,-158,-133
Hot Springs AR 2011,2011,Metropolitan Statistical Area,,,96641,485,1162,1345,-183,15,596,611,57
Houma-Thibodaux LA 2011,2011,Metropolitan Statistical Area,,,208626,405,2843,1757,1086,257,-881,-624,-57
Houston-The Woodlands-Sugar Land TX 2011,2011,Metropolitan Statistical Area,,,6060721,111645,92015,32862,59153,30627,22479,53106,-614
Huntington-Ashland WV-KY-OH 2011,2011,Metropolitan Statistical Area,,,364937,-233,4087,4219,-132,139,-232,-93,-8
Huntsville AL 2011,2011,Metropolitan Statistical Area,,,425248,5830,5265,3403,1862,606,3302,3908,60
Idaho Falls ID 2011,2011,Metropolitan Statistical Area,,,134922,1131,2539,870,1669,51,-581,-530,-8
Indianapolis-Carmel-Anderson IN 2011,2011,Metropolitan Statistical Area,,,1910206,17698,26912,14974,11938,4007,1555,5562,198
Iowa City IA 2011,2011,Metropolitan Statistical Area,,,155560,2597,2040,845,1195,839,541,1380,22
Ithaca NY 2011,2011,Metropolitan Statistical Area,,,102066,340,843,693,150,990,-821,169,21
Jackson MI 2011,2011,Metropolitan Statistical Area,,,159678,-471,1831,1502,329,104,-868,-764,-36
Jackson MS 2011,2011,Metropolitan Statistical Area,,,574402,5497,7876,4847,3029,499,1751,2250,218
Jackson TN 2011,2011,Metropolitan Statistical Area,,,129803,-240,1572,1258,314,76,-609,-533,-21
Jacksonville FL 2011,2011,Metropolitan Statistical Area,,,1361833,12696,17667,10972,6695,3182,2794,5976,25
Jacksonville NC 2011,2011,Metropolitan Statistical Area,,,177895,-1668,4433,865,3568,428,-5791,-5363,127
Janesville-Beloit WI 2011,2011,Metropolitan Statistical Area,,,160001,-229,1958,1397,561,40,-860,-820,30
Jefferson City MO 2011,2011,Metropolitan Statistical Area,,,150377,427,1788,1237,551,141,-227,-86,-38
Johnson City TN 2011,2011,Metropolitan Statistical Area,,,199794,818,2067,2123,-56,101,811,912,-38
Johnstown PA 2011,2011,Metropolitan Statistical Area,,,142566,-878,1374,1877,-503,55,-354,-299,-76
Jonesboro AR 2011,2011,Metropolitan Statistical Area,,,122840,1570,1677,1192,485,119,939,1058,27
Joplin MO 2011,2011,Metropolitan Statistical Area,,,176680,758,2500,1795,705,155,-325,-170,223
Kahului-Wailuku-Lahaina HI 2011,2011,Metropolitan Statistical Area,,,156854,1782,2032,1034,998,643,217,860,-76
Kalamazoo-Portage MI 2011,2011,Metropolitan Statistical Area,,,328432,1512,4013,2787,1226,548,-154,394,-108
Kankakee IL 2011,2011,Metropolitan Statistical Area,,,113453,-9,1340,1011,329,82,-378,-296,-42
Kansas City MO-KS 2011,2011,Metropolitan Statistical Area,,,2025003,11352,27719,15915,11804,3201,-3445,-244,-208
Kennewick-Richland WA 2011,2011,Metropolitan Statistical Area,,,263639,8061,4236,1638,2598,320,4973,5293,170
Killeen-Temple TX 2011,2011,Metropolitan Statistical Area,,,412715,4498,7949,2484,5465,929,-1918,-989,22
Kingsport-Bristol-Bristol TN-VA 2011,2011,Metropolitan Statistical Area,,,309107,-477,2942,3718,-776,50,305,355,-56
Kingston NY 2011,2011,Metropolitan Statistical Area,,,182613,239,1738,1579,159,325,-270,55,25
Knoxville TN 2011,2011,Metropolitan Statistical Area,,,842785,4098,9197,8480,717,708,2885,3593,-212
Kokomo IN 2011,2011,Metropolitan Statistical Area,,,82888,122,998,866,132,77,-121,-44,34
La Crosse-Onalaska WI-MN 2011,2011,Metropolitan Statistical Area,,,134238,382,1463,1161,302,142,-68,74,6
Lafayette LA 2011,2011,Metropolitan Statistical Area,,,470677,3027,6489,3996,2493,752,-117,635,-101
Lafayette-West Lafayette IN 2011,2011,Metropolitan Statistical Area,,,204434,2379,2434,1356,1078,1263,76,1339,-38
Lake Charles LA 2011,2011,Metropolitan Statistical Area,,,200592,523,2688,1899,789,218,-397,-179,-87
Lake Havasu City-Kingman AZ 2011,2011,Metropolitan Statistical Area,,,202642,2262,2012,2370,-358,-7,2573,2566,54
Lakeland-Winter Haven FL 2011,2011,Metropolitan Statistical Area,,,609696,6337,7173,5963,1210,2692,2767,5459,-332
Lancaster PA 2011,2011,Metropolitan Statistical Area,,,523670,3353,6974,4490,2484,1161,-206,955,-86
Lansing-East Lansing MI 2011,2011,Metropolitan Statistical Area,,,465980,1822,5278,3537,1741,1907,-1951,-44,125
Laredo TX 2011,2011,Metropolitan Statistical Area,,,255618,4310,5496,1170,4326,798,-721,77,-93
Las Cruces NM 2011,2011,Metropolitan Statistical Area,,,212890,2653,3307,1453,1854,91,779,870,-71
Las Vegas-Henderson-Paradise NV 2011,2011,Metropolitan Statistical Area,,,1967159,13896,26875,13614,13261,6546,-5499,1047,-412
Lawrence KS 2011,2011,Metropolitan Statistical Area,,,112491,1195,1233,608,625,562,16,578,-8
Lawton OK 2011,2011,Metropolitan Statistical Area,,,132267,642,2251,1017,1234,307,-885,-578,-14
Lebanon PA 2011,2011,Metropolitan Statistical Area,,,134544,816,1704,1420,284,394,162,556,-24
Lewiston ID-WA 2011,2011,Metropolitan Statistical Area,,,61342,324,700,707,-7,29,321,350,-19
Lewiston-Auburn ME 2011,2011,Metropolitan Statistical Area,,,107353,-308,1340,1019,321,104,-696,-592,-37
Lexington-Fayette KY 2011,2011,Metropolitan Statistical Area,,,478459,5057,6161,3522,2639,1178,1265,2443,-25
Lima OH 2011,2011,Metropolitan Statistical Area,,,105907,-457,1321,1078,243,59,-753,-694,-6
Lincoln NE 2011,2011,Metropolitan Statistical Area,,,306673,3751,4277,2185,2092,801,865,1666,-7
Little Rock-North Little Rock-Conway AR 2011,2011,Metropolitan Statistical Area,,,710759,8454,9979,6005,3974,787,3556,4343,137
Logan UT-ID 2011,2011,Metropolitan Statistical Area,,,127648,1572,2727,589,2138,301,-876,-575,9
Longview TX 2011,2011,Metropolitan Statistical Area,,,215968,1236,3098,2302,796,283,166,449,-9
Longview WA 2011,2011,Metropolitan Statistical Area,,,102329,-63,1251,940,311,13,-388,-375,1
Los Angeles-Long Beach-Anaheim CA 2011,2011,Metropolitan Statistical Area,,,12954525,109214,170889,75905,94984,62007,-43330,18677,-4447
Anaheim-Santa Ana-Irvine CA 2011,2011,Metropolitan Division,,,3056311,38231,38239,17674,20565,12302,6040,18342,-676
Los Angeles-Long Beach-Glendale CA 2011,2011,Metropolitan Division,,,9898214,70983,132650,58231,74419,49705,-49370,335,-3771
Louisville/Jefferson County KY-IN 2011,2011,Metropolitan Statistical Area,,,1244938,7160,15741,11400,4341,2097,1055,3152,-333
Lubbock TX 2011,2011,Metropolitan Statistical Area,,,295366,3214,4115,2341,1774,415,1032,1447,-7
Lynchburg VA 2011,2011,Metropolitan Statistical Area,,,254086,1062,2732,2533,199,361,417,778,85
Macon GA 2011,2011,Metropolitan Statistical Area,,,232851,544,3131,2297,834,169,-594,-425,135
Madera CA 2011,2011,Metropolitan Statistical Area,,,152148,994,2442,1008,1434,213,-587,-374,-66
Madison WI 2011,2011,Metropolitan Statistical Area,,,613773,7364,7292,4059,3233,1502,2302,3804,327
Manchester-Nashua NH 2011,2011,Metropolitan Statistical Area,,,401716,734,4546,2943,1603,902,-1661,-759,-110
Manhattan KS 2011,2011,Metropolitan Statistical Area,,,95424,2080,1482,474,1008,528,542,1070,2
Mankato-North Mankato MN 2011,2011,Metropolitan Statistical Area,,,97276,467,1173,662,511,100,-135,-35,-9
Mansfield OH 2011,2011,Metropolitan Statistical Area,,,123070,-1105,1417,1352,65,19,-1161,-1142,-28
McAllen-Edinburg-Mission TX 2011,2011,Metropolitan Statistical Area,,,795303,16109,16375,3572,12803,2094,1277,3371,-65
Medford OR 2011,2011,Metropolitan Statistical Area,,,204754,1333,2411,2188,223,64,996,1060,50
Memphis TN-MS-AR 2011,2011,Metropolitan Statistical Area,,,1332790,6210,18865,10863,8002,1609,-3324,-1715,-77
Merced CA 2011,2011,Metropolitan Statistical Area,,,259698,2967,4302,1461,2841,509,-341,168,-42
Miami-Fort Lauderdale-West Palm Beach FL 2011,2011,Metropolitan Statistical Area,,,5706892,120386,66101,45911,20190,62675,38210,100885,-689
Fort Lauderdale-Pompano Beach-Deerfield Beach FL 2011,2011,Metropolitan Division,,,1788367,34791,21124,14466,6658,15541,12996,28537,-404
Miami-Miami Beach-Kendall FL 2011,2011,Metropolitan Division,,,2579916,71227,31318,18397,12921,39202,18909,58111,195
West Palm Beach-Boca Raton-Delray Beach FL 2011,2011,Metropolitan Division,,,1338609,14368,13659,13048,611,7932,6305,14237,-480
Michigan City-La Porte IN 2011,2011,Metropolitan Statistical Area,,,111187,-234,1327,1139,188,13,-416,-403,-19
Midland MI 2011,2011,Metropolitan Statistical Area,,,83765,101,862,696,166,125,-150,-25,-40
Midland TX 2011,2011,Metropolitan Statistical Area,,,144996,3198,2333,1064,1269,109,1732,1841,88
Milwaukee-Waukesha-West Allis WI 2011,2011,Metropolitan Statistical Area,,,1561141,4606,20122,13059,7063,2266,-4329,-2063,-394
Minneapolis-St. Paul-Bloomington MN-WI 2011,2011,Metropolitan Statistical Area,,,3389149,34044,44909,21336,23573,10365,294,10659,-188
Missoula MT 2011,2011,Metropolitan Statistical Area,,,110121,696,1200,802,398,99,226,325,-27
Mobile AL 2011,2011,Metropolitan Statistical Area,,,413154,-278,5607,4138,1469,611,-2157,-1546,-201
Modesto CA 2011,2011,Metropolitan Statistical Area,,,518270,2987,7786,3675,4111,1235,-2314,-1079,-45
Monroe LA 2011,2011,Metropolitan Statistical Area,,,177390,605,2599,1752,847,171,-333,-162,-80
Monroe MI 2011,2011,Metropolitan Statistical Area,,,151499,-412,1593,1286,307,65,-806,-741,22
Montgomery AL 2011,2011,Metropolitan Statistical Area,,,377960,2752,4898,3279,1619,431,681,1112,21
Morgantown WV 2011,2011,Metropolitan Statistical Area,,,132314,1986,1427,1009,418,324,1241,1565,3
Morristown TN 2011,2011,Metropolitan Statistical Area,,,114800,583,1320,1243,77,83,410,493,13
Mount Vernon-Anacortes WA 2011,2011,Metropolitan Statistical Area,,,117740,773,1482,1085,397,121,234,355,21
Muncie IN 2011,2011,Metropolitan Statistical Area,,,117797,125,1265,1166,99,120,-18,102,-76
Muskegon MI 2011,2011,Metropolitan Statistical Area,,,169986,-1930,2134,1633,501,77,-2489,-2412,-19
Myrtle Beach-Conway-North Myrtle Beach SC-NC 2011,2011,Metropolitan Statistical Area,,,385705,7061,4144,3722,422,418,5826,6244,395
Napa CA 2011,2011,Metropolitan Statistical Area,,,138056,1227,1503,1158,345,488,409,897,-15
Naples-Immokalee-Marco Island FL 2011,2011,Metropolitan Statistical Area,,,327903,5193,3284,2854,430,2135,2181,4316,447
Nashville-Davidson--Murfreesboro--Franklin TN 2011,2011,Metropolitan Statistical Area,,,1698288,22375,22373,12882,9491,3676,8779,12455,429
New Bern NC 2011,2011,Metropolitan Statistical Area,,,128241,1136,1959,1316,643,219,131,350,143
New Haven-Milford CT 2011,2011,Metropolitan Statistical Area,,,864049,682,9265,7569,1696,3567,-4379,-812,-202
New Orleans-Metairie LA 2011,2011,Metropolitan Statistical Area,,,1214235,18441,15643,10148,5495,3038,9339,12377,569
New York-Newark-Jersey City NY-NJ-PA 2011,2011,Metropolitan Statistical Area,,,19756128,156594,255387,140460,114927,141150,-99000,42150,-483
Dutchess County-Putnam County NY 2011,2011,Metropolitan Division,,,398196,734,3662,2956,706,1046,-863,183,-155
Nassau County-Suffolk County NY 2011,2011,Metropolitan Division,,,2847637,11393,30767,22474,8293,9148,-5113,4035,-935
Newark NJ-PA 2011,2011,Metropolitan Division,,,2483320,10581,28679,18097,10582,13963,-14753,-790,789
New York-Jersey City-White Plains NY-NJ 2011,2011,Metropolitan Division,,,14026975,133886,192279,96933,95346,116993,-78271,38722,-182
Niles-Benton Harbor MI 2011,2011,Metropolitan Statistical Area,,,156544,-259,1944,1613,331,303,-952,-649,59
North Port-Sarasota-Bradenton FL 2011,2011,Metropolitan Statistical Area,,,708971,5509,6155,8393,-2238,1832,5800,7632,115
Norwich-New London CT 2011,2011,Metropolitan Statistical Area,,,274056,-46,2764,2229,535,1010,-1448,-438,-143
Ocala FL 2011,2011,Metropolitan Statistical Area,,,332507,980,3357,4351,-994,631,1395,2026,-52
Ocean City NJ 2011,2011,Metropolitan Statistical Area,,,96562,-716,892,1266,-374,170,-431,-261,-81
Odessa TX 2011,2011,Metropolitan Statistical Area,,,139690,2592,2409,1236,1173,46,1401,1447,-28
Ogden-Clearfield UT 2011,2011,Metropolitan Statistical Area,,,605878,6309,10804,3340,7464,555,-1717,-1162,7
Oklahoma City OK 2011,2011,Metropolitan Statistical Area,,,1276858,18970,18900,11237,7663,2393,8328,10721,586
Olympia-Tumwater WA 2011,2011,Metropolitan Statistical Area,,,256481,3435,3004,1907,1097,463,1869,2332,6
Omaha-Council Bluffs NE-IA 2011,2011,Metropolitan Statistical Area,,,876979,8866,13051,6281,6770,1618,739,2357,-261
Orlando-Kissimmee-Sanford FL 2011,2011,Metropolitan Statistical Area,,,2176088,36402,26290,14757,11533,15333,9435,24768,101
Oshkosh-Neenah WI 2011,2011,Metropolitan Statistical Area,,,167558,554,1878,1446,432,74,50,124,-2
Owensboro KY 2011,2011,Metropolitan Statistical Area,,,115361,570,1526,1159,367,38,183,221,-18
Oxnard-Thousand Oaks-Ventura CA 2011,2011,Metropolitan Statistical Area,,,830973,5620,11005,5085,5920,1657,-1752,-95,-205
Palm Bay-Melbourne-Titusville FL 2011,2011,Metropolitan Statistical Area,,,544431,402,5044,6189,-1145,1105,457,1562,-15
Panama City FL 2011,2011,Metropolitan Statistical Area,,,185370,259,2240,1761,479,199,-417,-218,-2
Parkersburg-Vienna WV 2011,2011,Metropolitan Statistical Area,,,92587,-128,1049,1109,-60,13,-59,-46,-22
Pensacola-Ferry Pass-Brent FL 2011,2011,Metropolitan Statistical Area,,,455339,4359,5611,4247,1364,598,2459,3057,-62
Peoria IL 2011,2011,Metropolitan Statistical Area,,,379677,723,4866,3761,1105,368,-620,-252,-130
Philadelphia-Camden-Wilmington PA-NJ-DE-MD 2011,2011,Metropolitan Statistical Area,,,5997083,25807,74023,52654,21369,18105,-12521,5584,-1146
Camden NJ 2011,2011,Metropolitan Division,,,1253155,1749,14390,10554,3836,2685,-4538,-1853,-234
Montgomery County-Bucks County-Chester County PA 2011,2011,Metropolitan Division,,,1935482,9207,20719,16304,4415,4079,959,5038,-246
Philadelphia PA 2011,2011,Metropolitan Division,,,2098441,10871,30160,19871,10289,9641,-8691,950,-368
Wilmington DE-MD-NJ 2011,2011,Metropolitan Division,,,710005,3980,8754,5925,2829,1700,-251,1449,-298
Phoenix-Mesa-Scottsdale AZ 2011,2011,Metropolitan Statistical Area,,,4254149,44802,58288,28304,29984,9639,3950,13589,1229
Pine Bluff AR 2011,2011,Metropolitan Statistical Area,,,99001,-1075,1191,989,202,6,-1304,-1298,21
Pittsburgh PA 2011,2011,Metropolitan Statistical Area,,,2359680,3002,23632,27196,-3564,2851,4952,7803,-1237
Pittsfield MA 2011,2011,Metropolitan Statistical Area,,,130575,-735,1185,1429,-244,185,-605,-420,-71
Pocatello ID 2011,2011,Metropolitan Statistical Area,,,83562,562,1423,658,765,73,-231,-158,-45
Portland-South Portland ME 2011,2011,Metropolitan Statistical Area,,,515995,2188,4863,4576,287,700,1280,1980,-79
Portland-Vancouver-Hillsboro OR-WA 2011,2011,Metropolitan Statistical Area,,,2260178,28099,27756,15678,12078,4896,10539,15435,586
Port St. Lucie FL 2011,2011,Metropolitan Statistical Area,,,428374,3128,4287,4381,-94,1001,1918,2919,303
Prescott AZ 2011,2011,Metropolitan Statistical Area,,,211185,668,1845,2612,-767,151,1122,1273,162
Providence-Warwick RI-MA 2011,2011,Metropolitan Statistical Area,,,1601145,-1009,16829,14867,1962,4768,-7423,-2655,-316
Provo-Orem UT 2011,2011,Metropolitan Statistical Area,,,540396,10566,12316,2075,10241,793,-462,331,-6
Pueblo CO 2011,2011,Metropolitan Statistical Area,,,160213,677,1864,1650,214,58,495,553,-90
Punta Gorda FL 2011,2011,Metropolitan Statistical Area,,,159613,-314,997,2273,-1276,247,872,1119,-157
Racine WI 2011,2011,Metropolitan Statistical Area,,,194979,-467,2497,1642,855,144,-1424,-1280,-42
Raleigh NC 2011,2011,Metropolitan Statistical Area,,,1163203,25857,15482,6089,9393,3817,12247,16064,400
Rapid City SD 2011,2011,Metropolitan Statistical Area,,,136354,1302,1903,1067,836,53,416,469,-3
Reading PA 2011,2011,Metropolitan Statistical Area,,,412580,675,4868,3662,1206,1200,-1508,-308,-223
Redding CA 2011,2011,Metropolitan Statistical Area,,,177950,664,2107,2077,30,197,321,518,116
Reno NV 2011,2011,Metropolitan Statistical Area,,,428858,2826,5389,3414,1975,697,86,783,68
Richmond VA 2011,2011,Metropolitan Statistical Area,,,1219592,9529,14609,9634,4975,3271,1103,4374,180
Riverside-San Bernardino-Ontario CA 2011,2011,Metropolitan Statistical Area,,,4302359,58117,62436,26668,35768,7815,14339,22154,195
Roanoke VA 2011,2011,Metropolitan Statistical Area,,,309390,609,3302,3373,-71,661,-146,515,165
Rochester MN 2011,2011,Metropolitan Statistical Area,,,208556,1416,2961,1507,1454,600,-748,-148,110
Rochester NY 2011,2011,Metropolitan Statistical Area,,,1082269,2187,11962,9538,2424,2847,-2809,38,-275
Rockford IL 2011,2011,Metropolitan Statistical Area,,,347890,-1405,4392,3105,1287,335,-2939,-2604,-88
Rocky Mount NC 2011,2011,Metropolitan Statistical Area,,,151845,-639,1760,1571,189,50,-868,-818,-10
Rome GA 2011,2011,Metropolitan Statistical Area,,,96182,-211,1303,979,324,101,-586,-485,-50
Sacramento--Roseville--Arden-Arcade CA 2011,2011,Metropolitan Statistical Area,,,2175727,21345,28102,15553,12549,6605,1918,8523,273
Saginaw MI 2011,2011,Metropolitan Statistical Area,,,198815,-1067,2229,1993,236,155,-1371,-1216,-87
St. Cloud MN 2011,2011,Metropolitan Statistical Area,,,190072,884,2529,1232,1297,222,-656,-434,21
St. George UT 2011,2011,Metropolitan Statistical Area,,,141502,3096,2388,1058,1330,62,1464,1526,240
St. Joseph MO-KS 2011,2011,Metropolitan Statistical Area,,,127747,469,1596,1314,282,152,-40,112,75
St. Louis MO-IL 2011,2011,Metropolitan Statistical Area,,,2793725,3839,34843,24822,10021,3862,-9574,-5712,-470
Salem OR 2011,2011,Metropolitan Statistical Area,,,393863,2376,5331,3145,2186,430,-128,302,-112
Salinas CA 2011,2011,Metropolitan Statistical Area,,,421393,5029,6863,2309,4554,926,-253,673,-198
Salisbury MD-DE 2011,2011,Metropolitan Statistical Area,,,378111,3349,4200,3871,329,926,2004,2930,90
Salt Lake City UT 2011,2011,Metropolitan Statistical Area,,,1107634,16202,19003,5994,13009,2914,611,3525,-332
San Angelo TX 2011,2011,Metropolitan Statistical Area,,,113429,1146,1526,1006,520,123,528,651,-25
San Antonio-New Braunfels TX 2011,2011,Metropolitan Statistical Area,,,2194231,40976,31264,14810,16454,4281,19848,24129,393
San Diego-Carlsbad CA 2011,2011,Metropolitan Statistical Area,,,3141768,37225,44696,19685,25011,11968,1089,13057,-843
San Francisco-Oakland-Hayward CA 2011,2011,Metropolitan Statistical Area,,,4400182,55003,51980,28486,23494,26170,6861,33031,-1522
Oakland-Hayward-Berkeley CA 2011,2011,Metropolitan Division,,,2599105,32586,31554,16331,15223,14046,4378,18424,-1061
San Francisco-Redwood City-South San Francisco CA 2011,2011,Metropolitan Division,,,1545664,19888,18042,10323,7719,11272,1186,12458,-289
San Rafael CA 2011,2011,Metropolitan Division,,,255413,2529,2384,1832,552,852,1297,2149,-172
San Jose-Sunnyvale-Santa Clara CA 2011,2011,Metropolitan Statistical Area,,,1870279,27817,24781,9426,15355,15913,-2476,13437,-975
San Luis Obispo-Paso Robles-Arroyo Grande CA 2011,2011,Metropolitan Statistical Area,,,271165,1305,2642,2250,392,203,784,987,-74
Santa Cruz-Watsonville CA 2011,2011,Metropolitan Statistical Area,,,264923,1710,3244,1707,1537,395,-135,260,-87
Santa Fe NM 2011,2011,Metropolitan Statistical Area,,,145447,944,1475,1026,449,397,152,549,-54
Santa Maria-Santa Barbara CA 2011,2011,Metropolitan Statistical Area,,,425974,1643,5748,2873,2875,1257,-2307,-1050,-182
Santa Rosa CA 2011,2011,Metropolitan Statistical Area,,,487722,3056,5308,3867,1441,651,975,1626,-11
Savannah GA 2011,2011,Metropolitan Statistical Area,,,355913,7070,4903,2816,2087,731,4240,4971,12
Scranton--Wilkes-Barre--Hazleton PA 2011,2011,Metropolitan Statistical Area,,,563913,258,5615,6992,-1377,1076,748,1824,-189
Seattle-Tacoma-Bellevue WA 2011,2011,Metropolitan Statistical Area,,,3498020,49786,44302,22646,21656,16357,12020,28377,-247
Seattle-Bellevue-Everett WA 2011,2011,Metropolitan Division,,,2694534,41748,33453,16869,16584,14794,10473,25267,-103
Tacoma-Lakewood WA 2011,2011,Metropolitan Division,,,803486,8038,10849,5777,5072,1563,1547,3110,-144
Sebastian-Vero Beach FL 2011,2011,Metropolitan Statistical Area,,,138973,738,1320,1740,-420,229,805,1034,124
Sebring FL 2011,2011,Metropolitan Statistical Area,,,98360,-343,915,1393,-478,221,-15,206,-71
Sheboygan WI 2011,2011,Metropolitan Statistical Area,,,115312,-106,1325,1022,303,92,-560,-468,59
Sherman-Denison TX 2011,2011,Metropolitan Statistical Area,,,121283,197,1554,1355,199,135,-54,81,-83
Shreveport-Bossier City LA 2011,2011,Metropolitan Statistical Area,,,445021,3860,6482,4347,2135,316,1551,1867,-142
Sierra Vista-Douglas AZ 2011,2011,Metropolitan Statistical Area,,,133058,1190,1773,1216,557,240,444,684,-51
Sioux City IA-NE-SD 2011,2011,Metropolitan Statistical Area,,,168940,147,2410,1520,890,275,-974,-699,-44
Sioux Falls SD 2011,2011,Metropolitan Statistical Area,,,232650,3551,3683,1692,1991,688,816,1504,56
South Bend-Mishawaka IN-MI 2011,2011,Metropolitan Statistical Area,,,319222,241,4012,3016,996,471,-1276,-805,50
Spartanburg SC 2011,2011,Metropolitan Statistical Area,,,314747,1071,3989,3106,883,185,107,292,-104
Spokane-Spokane Valley WA 2011,2011,Metropolitan Statistical Area,,,529837,1344,6427,4681,1746,622,-984,-362,-40
Springfield IL 2011,2011,Metropolitan Statistical Area,,,211634,1108,2544,1914,630,167,422,589,-111
Springfield MA 2011,2011,Metropolitan Statistical Area,,,626075,2649,6660,5436,1224,3351,-1673,1678,-253
Springfield MO 2011,2011,Metropolitan Statistical Area,,,440365,2921,5687,3871,1816,280,776,1056,49
Springfield OH 2011,2011,Metropolitan Statistical Area,,,137738,-489,1625,1596,29,59,-544,-485,-33
State College PA 2011,2011,Metropolitan Statistical Area,,,154847,665,1236,940,296,792,-352,440,-71
Staunton-Waynesboro VA 2011,2011,Metropolitan Statistical Area,,,118904,526,1226,1171,55,46,213,259,212
Stockton-Lodi CA 2011,2011,Metropolitan Statistical Area,,,695479,7966,10549,4754,5795,1661,545,2206,-35
Sumter SC 2011,2011,Metropolitan Statistical Area,,,107350,-231,1513,1054,459,92,-774,-682,-8
Syracuse NY 2011,2011,Metropolitan Statistical Area,,,662609,-367,7319,5850,1469,1588,-3212,-1624,-212
Tallahassee FL 2011,2011,Metropolitan Statistical Area,,,371156,1681,4113,2502,1611,767,-619,148,-78
Tampa-St. Petersburg-Clearwater FL 2011,2011,Metropolitan Statistical Area,,,2829104,39770,31331,28533,2798,10512,26828,37340,-368
Terre Haute IN 2011,2011,Metropolitan Statistical Area,,,172581,267,2058,1907,151,180,-19,161,-45
Texarkana TX-AR 2011,2011,Metropolitan Statistical Area,,,149561,246,1977,1594,383,41,-99,-58,-79
The Villages FL 2011,2011,Metropolitan Statistical Area,,,98598,4311,441,1209,-768,60,3769,3829,1250
Toledo OH 2011,2011,Metropolitan Statistical Area,,,609596,-605,7397,5625,1772,662,-3071,-2409,32
Topeka KS 2011,2011,Metropolitan Statistical Area,,,234671,462,3115,2224,891,130,-478,-348,-81
Trenton NJ 2011,2011,Metropolitan Statistical Area,,,367941,-102,4388,2939,1449,2405,-4033,-1628,77
Tucson AZ 2011,2011,Metropolitan Statistical Area,,,988125,6190,12078,8624,3454,1969,802,2771,-35
Tulsa OK 2011,2011,Metropolitan Statistical Area,,,945927,6069,13419,8970,4449,1108,438,1546,74
Tuscaloosa AL 2011,2011,Metropolitan Statistical Area,,,231400,911,2811,2194,617,245,77,322,-28
Tyler TX 2011,2011,Metropolitan Statistical Area,,,212765,2310,2984,1935,1049,257,1027,1284,-23
Urban Honolulu HI 2011,2011,Metropolitan Statistical Area,,,966559,10223,13782,7058,6724,5137,-1157,3980,-481
Utica-Rome NY 2011,2011,Metropolitan Statistical Area,,,298846,-455,3275,3159,116,679,-1240,-561,-10
Valdosta GA 2011,2011,Metropolitan Statistical Area,,,142414,2310,2163,1119,1044,110,1121,1231,35
Vallejo-Fairfield CA 2011,2011,Metropolitan Statistical Area,,,416945,2844,5174,2870,2304,1306,-703,603,-63
Victoria TX 2011,2011,Metropolitan Statistical Area,,,94650,580,1324,781,543,85,-5,80,-43
Vineland-Bridgeton NJ 2011,2011,Metropolitan Statistical Area,,,157607,407,2246,1435,811,486,-815,-329,-75
Virginia Beach-Norfolk-Newport News VA-NC 2011,2011,Metropolitan Statistical Area,,,1686982,6872,22678,12758,9920,3288,-5995,-2707,-341
Visalia-Porterville CA 2011,2011,Metropolitan Statistical Area,,,447824,4532,8151,2819,5332,398,-1052,-654,-146
Waco TX 2011,2011,Metropolitan Statistical Area,,,255729,1892,3600,2153,1447,276,279,555,-110
Walla Walla WA 2011,2011,Metropolitan Statistical Area,,,63545,516,726,578,148,66,299,365,3
Warner Robins GA 2011,2011,Metropolitan Statistical Area,,,183589,3177,2494,1368,1126,232,1615,1847,204
Washington-Arlington-Alexandria DC-VA-MD-WV 2011,2011,Metropolitan Statistical Area,,,5777721,111790,80329,31327,49002,39307,22678,61985,803
Silver Spring-Frederick-Rockville MD 2011,2011,Metropolitan Division,,,1230076,19970,16043,7178,8865,10109,1321,11430,-325
Washington-Arlington-Alexandria DC-VA-MD-WV 2011,2011,Metropolitan Division,,,4547645,91820,64286,24149,40137,29198,21357,50555,1128
Waterloo-Cedar Falls IA 2011,2011,Metropolitan Statistical Area,,,168250,362,2029,1476,553,174,-268,-94,-97
Watertown-Fort Drum NY 2011,2011,Metropolitan Statistical Area,,,118273,1678,2138,887,1251,242,80,322,105
Wausau WI 2011,2011,Metropolitan Statistical Area,,,134531,466,1657,1148,509,110,-221,-111,68
Weirton-Steubenville WV-OH 2011,2011,Metropolitan Statistical Area,,,123324,-942,1097,1748,-651,3,-300,-297,6
Wenatchee WA 2011,2011,Metropolitan Statistical Area,,,112091,830,1484,951,533,90,180,270,27
Wheeling WV-OH 2011,2011,Metropolitan Statistical Area,,,147075,-754,1450,1918,-468,38,-265,-227,-59
Wichita KS 2011,2011,Metropolitan Statistical Area,,,633266,1330,9590,5434,4156,821,-3629,-2808,-18
Wichita Falls TX 2011,2011,Metropolitan Statistical Area,,,150332,-1296,1949,1494,455,284,-2057,-1773,22
Williamsport PA 2011,2011,Metropolitan Statistical Area,,,116669,496,1208,1306,-98,67,581,648,-54
Wilmington NC 2011,2011,Metropolitan Statistical Area,,,259334,3600,2833,2149,684,261,2623,2884,32
Winchester VA-WV 2011,2011,Metropolitan Statistical Area,,,130047,1321,1586,1082,504,126,691,817,0
Winston-Salem NC 2011,2011,Metropolitan Statistical Area,,,644651,3300,7563,5873,1690,897,763,1660,-50
Worcester MA-CT 2011,2011,Metropolitan Statistical Area,,,922224,3433,10001,7589,2412,3535,-2211,1324,-303
Yakima WA 2011,2011,Metropolitan Statistical Area,,,246159,2013,4335,1843,2492,143,-558,-415,-64
York-Hanover PA 2011,2011,Metropolitan Statistical Area,,,436868,1325,5002,3739,1263,561,-405,156,-94
Youngstown-Warren-Boardman OH-PA 2011,2011,Metropolitan Statistical Area,,,562487,-2387,5576,6849,-1273,236,-1046,-810,-304
Yuba City CA 2011,2011,Metropolitan Statistical Area,,,167350,146,2588,1289,1299,548,-1687,-1139,-14
Yuma AZ 2011,2011,Metropolitan Statistical Area,,,202617,5512,3251,1339,1912,381,3160,3541,59
Abilene TX 2012,2012,Metropolitan Statistical Area,,,167529,892,2357,1585,772,464,-345,119,1
Akron OH 2012,2012,Metropolitan Statistical Area,,,702203,-678,7551,7001,550,1062,-2301,-1239,11
Albany GA 2012,2012,Metropolitan Statistical Area,,,157355,-436,2182,1395,787,116,-1359,-1243,20
Albany OR 2012,2012,Metropolitan Statistical Area,,,118360,243,1445,1125,320,36,-108,-72,-5
Albany-Schenectady-Troy NY 2012,2012,Metropolitan Statistical Area,,,875270,2304,9115,7652,1463,2432,-1540,892,-51
Albuquerque NM 2012,2012,Metropolitan Statistical Area,,,901016,3925,11018,6614,4404,1144,-1566,-422,-57
Alexandria LA 2012,2012,Metropolitan Statistical Area,,,154487,68,2025,1586,439,169,-540,-371,0
Allentown-Bethlehem-Easton PA-NJ 2012,2012,Metropolitan Statistical Area,,,827109,1880,8554,7590,964,2361,-1432,929,-13
Altoona PA 2012,2012,Metropolitan Statistical Area,,,126999,-176,1334,1497,-163,35,-31,4,-17
Amarillo TX 2012,2012,Metropolitan Statistical Area,,,257755,1767,3704,2196,1508,622,-377,245,14
Ames IA 2012,2012,Metropolitan Statistical Area,,,91721,825,905,436,469,636,-280,356,0
Anchorage AK 2012,2012,Metropolitan Statistical Area,,,392431,4291,5901,2030,3871,1608,-1190,418,2
Ann Arbor MI 2012,2012,Metropolitan Statistical Area,,,351301,2151,3780,2074,1706,1948,-1522,426,19
Anniston-Oxford-Jacksonville AL 2012,2012,Metropolitan Statistical Area,,,117264,-496,1355,1361,-6,43,-534,-491,1
Appleton WI 2012,2012,Metropolitan Statistical Area,,,228581,1170,2841,1544,1297,183,-310,-127,0
Asheville NC 2012,2012,Metropolitan Statistical Area,,,432142,3706,4392,4409,-17,352,3370,3722,1
Athens-Clarke County GA 2012,2012,Metropolitan Statistical Area,,,196405,1747,2201,1229,972,434,316,750,25
Atlanta-Sandy Springs-Roswell GA 2012,2012,Metropolitan Statistical Area,,,5456472,81647,72556,31349,41207,17003,23294,40297,143
Atlantic City-Hammonton NJ 2012,2012,Metropolitan Statistical Area,,,275566,643,3430,2432,998,1427,-1813,-386,31
Auburn-Opelika AL 2012,2012,Metropolitan Statistical Area,,,148040,3894,1660,879,781,629,2424,3053,60
Augusta-Richmond County GA-SC 2012,2012,Metropolitan Statistical Area,,,576755,5708,7501,4873,2628,1295,1721,3016,64
Austin-Round Rock TX 2012,2012,Metropolitan Statistical Area,,,1836149,54060,24843,8412,16431,5763,31142,36905,724
Bakersfield CA 2012,2012,Metropolitan Statistical Area,,,856502,6630,14206,5250,8956,1708,-4080,-2372,46
Baltimore-Columbia-Towson MD 2012,2012,Metropolitan Statistical Area,,,2756231,21026,33629,22543,11086,9392,823,10215,-275
Bangor ME 2012,2012,Metropolitan Statistical Area,,,153612,-187,1480,1490,-10,158,-328,-170,-7
Barnstable Town MA 2012,2012,Metropolitan Statistical Area,,,214845,-490,1591,2680,-1089,346,265,611,-12
Baton Rouge LA 2012,2012,Metropolitan Statistical Area,,,814993,6336,10878,6223,4655,1213,482,1695,-14
Battle Creek MI 2012,2012,Metropolitan Statistical Area,,,134760,-522,1621,1451,170,190,-890,-700,8
Bay City MI 2012,2012,Metropolitan Statistical Area,,,107084,-393,1068,1185,-117,44,-324,-280,4
Beaumont-Port Arthur TX 2012,2012,Metropolitan Statistical Area,,,403832,-1443,5293,3874,1419,531,-3443,-2912,50
Beckley WV 2012,2012,Metropolitan Statistical Area,,,125020,-167,1539,1621,-82,86,-166,-80,-5
Bellingham WA 2012,2012,Metropolitan Statistical Area,,,204827,1498,2259,1478,781,284,443,727,-10
Bend-Redmond OR 2012,2012,Metropolitan Statistical Area,,,161746,1960,1666,1313,353,-25,1674,1649,-42
Billings MT 2012,2012,Metropolitan Statistical Area,,,162839,2078,2101,1444,657,50,1366,1416,5
Binghamton NY 2012,2012,Metropolitan Statistical Area,,,249005,-1246,2572,2478,94,453,-1822,-1369,29
Birmingham-Hoover AL 2012,2012,Metropolitan Statistical Area,,,1134297,3287,14796,11182,3614,1111,-1403,-292,-35
Bismarck ND 2012,2012,Metropolitan Statistical Area,,,120293,2900,1717,962,755,36,2086,2122,23
Blacksburg-Christiansburg-Radford VA 2012,2012,Metropolitan Statistical Area,,,179558,647,1687,1469,218,689,-260,429,0
Bloomington IL 2012,2012,Metropolitan Statistical Area,,,188910,1628,2283,1203,1080,540,24,564,-16
Bloomington IN 2012,2012,Metropolitan Statistical Area,,,162652,797,1535,1058,477,867,-537,330,-10
Bloomsburg-Berwick PA 2012,2012,Metropolitan Statistical Area,,,85415,106,828,899,-71,158,28,186,-9
Boise City ID 2012,2012,Metropolitan Statistical Area,,,637651,10024,8410,4112,4298,848,4928,5776,-50
Boston-Cambridge-Newton MA-NH 2012,2012,Metropolitan Statistical Area,,,4650668,41820,51154,33650,17504,27090,-2314,24776,-460
Boston MA 2012,2012,Metropolitan Division,,,1931329,17646,21703,13884,7819,12370,-2406,9964,-137
Cambridge-Newton-Framingham MA 2012,2012,Metropolitan Division,,,2296955,21734,25724,16836,8888,14366,-1231,13135,-289
Rockingham County-Strafford County NH 2012,2012,Metropolitan Division,,,422384,2440,3727,2930,797,354,1323,1677,-34
Boulder CO 2012,2012,Metropolitan Statistical Area,,,305483,4833,2964,1576,1388,824,2610,3434,11
Bowling Green KY 2012,2012,Metropolitan Statistical Area,,,162352,1848,1960,1398,562,460,813,1273,13
Bremerton-Silverdale WA 2012,2012,Metropolitan Statistical Area,,,254659,287,3027,1920,1107,614,-1458,-844,24
Bridgeport-Stamford-Norwalk CT 2012,2012,Metropolitan Statistical Area,,,935290,6568,10203,6367,3836,5698,-2815,2883,-151
Brownsville-Harlingen TX 2012,2012,Metropolitan Statistical Area,,,416048,2860,7359,2366,4993,614,-2801,-2187,54
Brunswick GA 2012,2012,Metropolitan Statistical Area,,,113437,403,1344,1018,326,108,-35,73,4
Buffalo-Cheektowaga-Niagara Falls NY 2012,2012,Metropolitan Statistical Area,,,1135067,-344,11979,11686,293,3017,-3623,-606,-31
Burlington NC 2012,2012,Metropolitan Statistical Area,,,153672,806,1707,1495,212,126,495,621,-27
Burlington-South Burlington VT 2012,2012,Metropolitan Statistical Area,,,213874,1037,2240,1460,780,450,-175,275,-18
California-Lexington Park MD 2012,2012,Metropolitan Statistical Area,,,108999,1242,1389,696,693,292,259,551,-2
Canton-Massillon OH 2012,2012,Metropolitan Statistical Area,,,403404,285,4336,4253,83,235,-18,217,-15
Cape Coral-Fort Myers FL 2012,2012,Metropolitan Statistical Area,,,644988,13576,6400,6056,344,2679,10509,13188,44
Cape Girardeau MO-IL 2012,2012,Metropolitan Statistical Area,,,97235,208,1198,910,288,110,-178,-68,-12
Carbondale-Marion IL 2012,2012,Metropolitan Statistical Area,,,126984,-123,1434,1230,204,291,-619,-328,1
Carson City NV 2012,2012,Metropolitan Statistical Area,,,54578,-169,549,658,-109,-1,-47,-48,-12
Casper WY 2012,2012,Metropolitan Statistical Area,,,78686,2270,1044,657,387,40,1793,1833,50
Cedar Rapids IA 2012,2012,Metropolitan Statistical Area,,,261686,824,3218,2059,1159,298,-603,-305,-30
Chambersburg-Waynesboro PA 2012,2012,Metropolitan Statistical Area,,,151589,585,1910,1408,502,200,-107,93,-10
Champaign-Urbana IL 2012,2012,Metropolitan Statistical Area,,,234514,1182,2753,1512,1241,1751,-1841,-90,31
Charleston WV 2012,2012,Metropolitan Statistical Area,,,225800,-79,2645,2718,-73,82,-74,8,-14
Charleston-North Charleston SC 2012,2012,Metropolitan Statistical Area,,,697435,15953,9188,4899,4289,1589,9866,11455,209
Charlotte-Concord-Gastonia NC-SC 2012,2012,Metropolitan Statistical Area,,,2295879,38730,29282,16326,12956,5127,20453,25580,194
Charlottesville VA 2012,2012,Metropolitan Statistical Area,,,223151,1812,2392,1629,763,841,227,1068,-19
Chattanooga TN-GA 2012,2012,Metropolitan Statistical Area,,,537997,4835,6312,5216,1096,538,3111,3649,90
Cheyenne WY 2012,2012,Metropolitan Statistical Area,,,94849,2242,1220,718,502,232,1459,1691,49
Chicago-Naperville-Elgin IL-IN-WI 2012,2012,Metropolitan Statistical Area,,,9519316,25852,122181,67091,55090,24867,-53677,-28810,-428
Chicago-Naperville-Arlington Heights IL 2012,2012,Metropolitan Division,,,7317530,24135,95390,51533,43857,21354,-40514,-19160,-562
Elgin IL 2012,2012,Metropolitan Division,,,626536,2093,8181,3571,4610,751,-3322,-2571,54
Gary IN 2012,2012,Metropolitan Division,,,706385,-1408,8538,6338,2200,342,-3953,-3611,3
Lake County-Kenosha County IL-WI 2012,2012,Metropolitan Division,,,868865,1032,10072,5649,4423,2420,-5888,-3468,77
Chico CA 2012,2012,Metropolitan Statistical Area,,,221279,1254,2399,2245,154,247,873,1120,-20
Cincinnati OH-KY-IN 2012,2012,Metropolitan Statistical Area,,,2129786,6454,27479,18177,9302,3350,-6102,-2752,-96
Clarksville TN-KY 2012,2012,Metropolitan Statistical Area,,,275522,10911,5148,1843,3305,2540,4910,7450,156
Cleveland TN 2012,2012,Metropolitan Statistical Area,,,117730,1073,1343,1158,185,106,764,870,18
Cleveland-Elyria OH 2012,2012,Metropolitan Statistical Area,,,2064570,-3829,23108,21149,1959,3760,-9556,-5796,8
Coeur d'Alene ID 2012,2012,Metropolitan Statistical Area,,,142297,1252,1685,1230,455,42,778,820,-23
College Station-Bryan TX 2012,2012,Metropolitan Statistical Area,,,234373,2795,2982,1246,1736,1380,-305,1075,-16
Colorado Springs CO 2012,2012,Metropolitan Statistical Area,,,669100,8822,9319,3914,5405,2803,669,3472,-55
Columbia MO 2012,2012,Metropolitan Statistical Area,,,168592,2670,2118,953,1165,608,876,1484,21
Columbia SC 2012,2012,Metropolitan Statistical Area,,,784279,7649,9475,6073,3402,1945,2362,4307,-60
Columbus GA-AL 2012,2012,Metropolitan Statistical Area,,,311711,9198,4969,2656,2313,1783,4993,6776,109
Columbus IN 2012,2012,Metropolitan Statistical Area,,,78903,1282,1067,703,364,241,665,906,12
Columbus OH 2012,2012,Metropolitan Statistical Area,,,1945659,20119,26649,14304,12345,4976,2745,7721,53
Corpus Christi TX 2012,2012,Metropolitan Statistical Area,,,437012,5961,5827,3587,2240,800,2894,3694,27
Corvallis OR 2012,2012,Metropolitan Statistical Area,,,86380,397,733,572,161,349,-110,239,-3
Crestview-Fort Walton Beach-Destin FL 2012,2012,Metropolitan Statistical Area,,,247712,8758,3331,2013,1318,1128,6182,7310,130
Cumberland MD-WV 2012,2012,Metropolitan Statistical Area,,,101816,-804,955,1216,-261,42,-593,-551,8
Dallas-Fort Worth-Arlington TX 2012,2012,Metropolitan Statistical Area,,,6710066,135200,95680,38066,57614,21918,55171,77089,497
Dallas-Plano-Irving TX 2012,2012,Metropolitan Division,,,4432840,96825,63374,23715,39659,16290,40415,56705,461
Fort Worth-Arlington TX 2012,2012,Metropolitan Division,,,2277226,38375,32306,14351,17955,5628,14756,20384,36
Dalton GA 2012,2012,Metropolitan Statistical Area,,,142581,77,1901,1111,790,84,-807,-723,10
Danville IL 2012,2012,Metropolitan Statistical Area,,,80764,-594,1077,930,147,22,-766,-744,3
Daphne-Fairhope-Foley AL 2012,2012,Metropolitan Statistical Area,,,190561,3867,2093,1884,209,269,3364,3633,25
Davenport-Moline-Rock Island IA-IL 2012,2012,Metropolitan Statistical Area,,,382139,1213,4485,3709,776,494,-59,435,2
Dayton OH 2012,2012,Metropolitan Statistical Area,,,802234,900,9720,8001,1719,1596,-2420,-824,5
Decatur AL 2012,2012,Metropolitan Statistical Area,,,153833,-81,1770,1609,161,95,-334,-239,-3
Decatur IL 2012,2012,Metropolitan Statistical Area,,,110043,-539,1325,1188,137,75,-757,-682,6
Deltona-Daytona Beach-Ormond Beach FL 2012,2012,Metropolitan Statistical Area,,,595602,3849,5556,7304,-1748,1132,4551,5683,-86
Denver-Aurora-Lakewood CO 2012,2012,Metropolitan Statistical Area,,,2647780,46937,33961,15752,18209,5620,22631,28251,477
Des Moines-West Des Moines IA 2012,2012,Metropolitan Statistical Area,,,589453,8712,8583,4068,4515,1414,2762,4176,21
Detroit-Warren-Dearborn MI 2012,2012,Metropolitan Statistical Area,,,4292912,5767,49883,38948,10935,10237,-15269,-5032,-136
Detroit-Dearborn-Livonia MI 2012,2012,Metropolitan Division,,,1792770,-8844,23269,17497,5772,3728,-18342,-14614,-2
Warren-Troy-Farmington Hills MI 2012,2012,Metropolitan Division,,,2500142,14611,26614,21451,5163,6509,3073,9582,-134
Dothan AL 2012,2012,Metropolitan Statistical Area,,,147618,963,1826,1585,241,76,638,714,8
Dover DE 2012,2012,Metropolitan Statistical Area,,,167666,2452,2171,1379,792,535,1132,1667,-7
Dubuque IA 2012,2012,Metropolitan Statistical Area,,,95147,640,1162,863,299,73,278,351,-10
Duluth MN-WI 2012,2012,Metropolitan Statistical Area,,,279614,-293,2914,2842,72,233,-593,-360,-5
Durham-Chapel Hill NC 2012,2012,Metropolitan Statistical Area,,,525026,9198,6586,3424,3162,2024,3946,5970,66
East Stroudsburg PA 2012,2012,Metropolitan Statistical Area,,,168465,-1395,1353,1295,58,182,-1652,-1470,17
Eau Claire WI 2012,2012,Metropolitan Statistical Area,,,163891,1053,1963,1273,690,81,282,363,0
El Centro CA 2012,2012,Metropolitan Statistical Area,,,177443,1143,3021,957,2064,235,-1177,-942,21
Elizabethtown-Fort Knox KY 2012,2012,Metropolitan Statistical Area,,,150413,-882,1897,1159,738,629,-2292,-1663,43
Elkhart-Goshen IN 2012,2012,Metropolitan Statistical Area,,,199236,756,2985,1660,1325,111,-687,-576,7
Elmira NY 2012,2012,Metropolitan Statistical Area,,,89231,258,1049,916,133,73,57,130,-5
El Paso TX 2012,2012,Metropolitan Statistical Area,,,834477,11343,13975,4831,9144,2922,-656,2266,-67
Erie PA 2012,2012,Metropolitan Statistical Area,,,280801,-137,3189,2817,372,402,-916,-514,5
Eugene OR 2012,2012,Metropolitan Statistical Area,,,354481,990,3475,3405,70,628,346,974,-54
Evansville IN-KY 2012,2012,Metropolitan Statistical Area,,,313298,709,3791,2972,819,187,-282,-95,-15
Fairbanks AK 2012,2012,Metropolitan Statistical Area,,,100227,2198,1595,451,1144,483,551,1034,20
Fargo ND-MN 2012,2012,Metropolitan Statistical Area,,,217052,4217,3148,1254,1894,669,1635,2304,19
Farmington NM 2012,2012,Metropolitan Statistical Area,,,128367,332,1867,895,972,11,-646,-635,-5
Fayetteville NC 2012,2012,Metropolitan Statistical Area,,,373566,237,6612,2590,4022,3046,-6990,-3944,159
Fayetteville-Springdale-Rogers AR-MO 2012,2012,Metropolitan Statistical Area,,,483029,8807,7198,3488,3710,1279,3775,5054,43
Flagstaff AZ 2012,2012,Metropolitan Statistical Area,,,135949,1790,1724,729,995,112,665,777,18
Flint MI 2012,2012,Metropolitan Statistical Area,,,418058,-3658,4971,4201,770,240,-4765,-4525,97
Florence SC 2012,2012,Metropolitan Statistical Area,,,206225,479,2628,2201,427,123,-49,74,-22
Florence-Muscle Shoals AL 2012,2012,Metropolitan Statistical Area,,,147167,125,1515,1692,-177,93,212,305,-3
Fond du Lac WI 2012,2012,Metropolitan Statistical Area,,,101702,-90,1122,910,212,69,-372,-303,1
Fort Collins CO 2012,2012,Metropolitan Statistical Area,,,310835,5594,3408,1871,1537,362,3643,4005,52
Fort Smith AR-OK 2012,2012,Metropolitan Statistical Area,,,280704,-308,3475,2915,560,117,-983,-866,-2
Fort Wayne IN 2012,2012,Metropolitan Statistical Area,,,421780,2023,5942,3505,2437,784,-1200,-416,2
Fresno CA 2012,2012,Metropolitan Statistical Area,,,948240,6980,15945,6277,9668,1813,-4560,-2747,59
Gadsden AL 2012,2012,Metropolitan Statistical Area,,,104324,14,1154,1408,-254,55,218,273,-5
Gainesville FL 2012,2012,Metropolitan Statistical Area,,,268585,1894,3193,1854,1339,1269,-702,567,-12
Gainesville GA 2012,2012,Metropolitan Statistical Area,,,185084,2130,2547,1250,1297,240,640,880,-47
Gettysburg PA 2012,2012,Metropolitan Statistical Area,,,101538,-111,934,921,13,53,-167,-114,-10
Glens Falls NY 2012,2012,Metropolitan Statistical Area,,,128476,-306,1268,1264,4,46,-355,-309,-1
Goldsboro NC 2012,2012,Metropolitan Statistical Area,,,124504,482,1768,1115,653,459,-638,-179,8
Grand Forks ND-MN 2012,2012,Metropolitan Statistical Area,,,99214,1019,1399,814,585,362,71,433,1
Grand Island NE 2012,2012,Metropolitan Statistical Area,,,83462,779,1148,736,412,322,57,379,-12
Grand Junction CO 2012,2012,Metropolitan Statistical Area,,,147724,344,1817,1306,511,54,-204,-150,-17
Grand Rapids-Wyoming MI 2012,2012,Metropolitan Statistical Area,,,1006131,9776,13535,7163,6372,1429,2016,3445,-41
Grants Pass OR 2012,2012,Metropolitan Statistical Area,,,82782,164,781,1158,-377,7,550,557,-16
Great Falls MT 2012,2012,Metropolitan Statistical Area,,,81765,18,1178,789,389,279,-658,-379,8
Greeley CO 2012,2012,Metropolitan Statistical Area,,,264189,5452,3794,1459,2335,276,2815,3091,26
Green Bay WI 2012,2012,Metropolitan Statistical Area,,,311052,2289,4005,2327,1678,373,275,648,-37
Greensboro-High Point NC 2012,2012,Metropolitan Statistical Area,,,735866,5789,8571,6184,2387,1486,1950,3436,-34
Greenville NC 2012,2012,Metropolitan Statistical Area,,,172895,2132,2154,1186,968,212,937,1149,15
Greenville-Anderson-Mauldin SC 2012,2012,Metropolitan Statistical Area,,,842037,8620,10265,7589,2676,1372,4565,5937,7
Gulfport-Biloxi-Pascagoula MS 2012,2012,Metropolitan Statistical Area,,,378970,3208,4896,3405,1491,1103,626,1729,-12
Hagerstown-Martinsburg MD-WV 2012,2012,Metropolitan Statistical Area,,,256224,1691,3081,2348,733,298,658,956,2
Hammond LA 2012,2012,Metropolitan Statistical Area,,,123767,1040,1896,1140,756,99,195,294,-10
Hanford-Corcoran CA 2012,2012,Metropolitan Statistical Area,,,151340,-723,2397,806,1591,498,-2860,-2362,48
Harrisburg-Carlisle PA 2012,2012,Metropolitan Statistical Area,,,554827,2892,6407,5065,1342,1421,128,1549,1
Harrisonburg VA 2012,2012,Metropolitan Statistical Area,,,128599,1679,1342,950,392,418,859,1277,10
Hartford-West Hartford-East Hartford CT 2012,2012,Metropolitan Statistical Area,,,1215143,-1250,12075,10101,1974,5235,-8477,-3242,18
Hattiesburg MS 2012,2012,Metropolitan Statistical Area,,,146713,1415,2000,1212,788,128,489,617,10
Hickory-Lenoir-Morganton NC 2012,2012,Metropolitan Statistical Area,,,363711,-681,3884,3745,139,254,-1067,-813,-7
Hilton Head Island-Bluffton-Beaufort SC 2012,2012,Metropolitan Statistical Area,,,193755,4231,2363,1468,895,1214,2117,3331,5
Hinesville GA 2012,2012,Metropolitan Statistical Area,,,81552,1194,1936,392,1544,974,-1364,-390,40
Homosassa Springs FL 2012,2012,Metropolitan Statistical Area,,,139290,-483,1065,2309,-1244,79,683,762,-1
Hot Springs AR 2012,2012,Metropolitan Statistical Area,,,96837,196,1089,1350,-261,12,440,452,5
Houma-Thibodaux LA 2012,2012,Metropolitan Statistical Area,,,208856,230,2894,1818,1076,250,-1102,-852,6
Houston-The Woodlands-Sugar Land TX 2012,2012,Metropolitan Statistical Area,,,6186923,126202,91505,33683,57822,28914,39229,68143,237
Huntington-Ashland WV-KY-OH 2012,2012,Metropolitan Statistical Area,,,364944,7,4133,4038,95,153,-230,-77,-11
Huntsville AL 2012,2012,Metropolitan Statistical Area,,,430231,4983,5036,3291,1745,641,2589,3230,8
Idaho Falls ID 2012,2012,Metropolitan Statistical Area,,,136259,1337,2425,960,1465,46,-166,-120,-8
Indianapolis-Carmel-Anderson IN 2012,2012,Metropolitan Statistical Area,,,1928783,18577,26472,15279,11193,3966,3522,7488,-104
Iowa City IA 2012,2012,Metropolitan Statistical Area,,,158834,3274,2059,859,1200,842,1213,2055,19
Ithaca NY 2012,2012,Metropolitan Statistical Area,,,103044,978,933,652,281,1009,-312,697,0
Jackson MI 2012,2012,Metropolitan Statistical Area,,,160156,478,1799,1586,213,105,183,288,-23
Jackson MS 2012,2012,Metropolitan Statistical Area,,,576899,2497,7806,4933,2873,539,-888,-349,-27
Jackson TN 2012,2012,Metropolitan Statistical Area,,,130378,575,1666,1205,461,74,46,120,-6
Jacksonville FL 2012,2012,Metropolitan Statistical Area,,,1378834,17001,17366,11140,6226,4175,6693,10868,-93
Jacksonville NC 2012,2012,Metropolitan Statistical Area,,,183888,5993,4189,924,3265,3200,-486,2714,14
Janesville-Beloit WI 2012,2012,Metropolitan Statistical Area,,,160271,270,1926,1407,519,42,-295,-253,4
Jefferson City MO 2012,2012,Metropolitan Statistical Area,,,150366,-11,1768,1238,530,152,-700,-548,7
Johnson City TN 2012,2012,Metropolitan Statistical Area,,,200524,730,2027,2211,-184,95,804,899,15
Johnstown PA 2012,2012,Metropolitan Statistical Area,,,141531,-1035,1361,1763,-402,61,-692,-631,-2
Jonesboro AR 2012,2012,Metropolitan Statistical Area,,,124228,1388,1731,1201,530,120,717,837,21
Joplin MO 2012,2012,Metropolitan Statistical Area,,,174445,-2235,2481,1673,808,152,-3194,-3042,-1
Kahului-Wailuku-Lahaina HI 2012,2012,Metropolitan Statistical Area,,,158521,1667,2033,1087,946,653,77,730,-9
Kalamazoo-Portage MI 2012,2012,Metropolitan Statistical Area,,,330270,1838,4016,2624,1392,568,-142,426,20
Kankakee IL 2012,2012,Metropolitan Statistical Area,,,112926,-527,1384,1019,365,72,-968,-896,4
Kansas City MO-KS 2012,2012,Metropolitan Statistical Area,,,2039213,14210,27576,15930,11646,3442,-756,2686,-122
Kennewick-Richland WA 2012,2012,Metropolitan Statistical Area,,,268227,4588,4368,1596,2772,285,1519,1804,12
Killeen-Temple TX 2012,2012,Metropolitan Statistical Area,,,420364,7649,7075,2476,4599,3359,-319,3040,10
Kingsport-Bristol-Bristol TN-VA 2012,2012,Metropolitan Statistical Area,,,308872,-235,2977,3831,-854,54,583,637,-18
Kingston NY 2012,2012,Metropolitan Statistical Area,,,181708,-905,1639,1612,27,333,-1279,-946,14
Knoxville TN 2012,2012,Metropolitan Statistical Area,,,847817,5032,9443,8596,847,721,3468,4189,-4
Kokomo IN 2012,2012,Metropolitan Statistical Area,,,82973,85,988,898,90,76,-81,-5,0
La Crosse-Onalaska WI-MN 2012,2012,Metropolitan Statistical Area,,,135647,1409,1458,1122,336,143,925,1068,5
Lafayette LA 2012,2012,Metropolitan Statistical Area,,,474220,3543,6509,3841,2668,730,144,874,1
Lafayette-West Lafayette IN 2012,2012,Metropolitan Statistical Area,,,207110,2676,2582,1385,1197,1284,219,1503,-24
Lake Charles LA 2012,2012,Metropolitan Statistical Area,,,201276,684,2780,1856,924,237,-469,-232,-8
Lake Havasu City-Kingman AZ 2012,2012,Metropolitan Statistical Area,,,203174,532,1869,2577,-708,-6,1228,1222,18
Lakeland-Winter Haven FL 2012,2012,Metropolitan Statistical Area,,,615764,6068,7250,5832,1418,2626,2035,4661,-11
Lancaster PA 2012,2012,Metropolitan Statistical Area,,,526766,3096,7053,4531,2522,1176,-561,615,-41
Lansing-East Lansing MI 2012,2012,Metropolitan Statistical Area,,,466666,686,5151,3391,1760,1964,-3093,-1129,55
Laredo TX 2012,2012,Metropolitan Statistical Area,,,259986,4368,5437,1253,4184,601,-408,193,-9
Las Cruces NM 2012,2012,Metropolitan Statistical Area,,,214208,1318,3066,1490,1576,155,-409,-254,-4
Las Vegas-Henderson-Paradise NV 2012,2012,Metropolitan Statistical Area,,,1998646,31487,26101,13795,12306,6848,12258,19106,75
Lawrence KS 2012,2012,Metropolitan Statistical Area,,,113339,848,1265,593,672,580,-399,181,-5
Lawton OK 2012,2012,Metropolitan Statistical Area,,,132758,491,2072,1051,1021,898,-1436,-538,8
Lebanon PA 2012,2012,Metropolitan Statistical Area,,,135582,1038,1608,1391,217,427,414,841,-20
Lewiston ID-WA 2012,2012,Metropolitan Statistical Area,,,61450,108,708,741,-33,32,110,142,-1
Lewiston-Auburn ME 2012,2012,Metropolitan Statistical Area,,,107506,153,1317,1021,296,110,-257,-147,4
Lexington-Fayette KY 2012,2012,Metropolitan Statistical Area,,,484616,6157,6260,3509,2751,1155,2213,3368,38
Lima OH 2012,2012,Metropolitan Statistical Area,,,105283,-624,1225,1071,154,60,-857,-797,19
Lincoln NE 2012,2012,Metropolitan Statistical Area,,,310434,3761,4221,2070,2151,837,790,1627,-17
Little Rock-North Little Rock-Conway AR 2012,2012,Metropolitan Statistical Area,,,717703,6944,9834,6080,3754,1106,2082,3188,2
Logan UT-ID 2012,2012,Metropolitan Statistical Area,,,128769,1121,2538,571,1967,306,-1159,-853,7
Longview TX 2012,2012,Metropolitan Statistical Area,,,218591,2623,3087,2145,942,235,1387,1622,59
Longview WA 2012,2012,Metropolitan Statistical Area,,,101777,-552,1208,1047,161,20,-738,-718,5
Los Angeles-Long Beach-Anaheim CA 2012,2012,Metropolitan Statistical Area,,,13064761,110236,166999,75858,91141,58842,-38512,20330,-1235
Anaheim-Santa Ana-Irvine CA 2012,2012,Metropolitan Division,,,3089893,33582,37842,17821,20021,11880,1931,13811,-250
Los Angeles-Long Beach-Glendale CA 2012,2012,Metropolitan Division,,,9974868,76654,129157,58037,71120,46962,-40443,6519,-985
Louisville/Jefferson County KY-IN 2012,2012,Metropolitan Statistical Area,,,1251870,6932,15615,11513,4102,2139,706,2845,-15
Lubbock TX 2012,2012,Metropolitan Statistical Area,,,297972,2606,4005,2323,1682,410,524,934,-10
Lynchburg VA 2012,2012,Metropolitan Statistical Area,,,255534,1448,2735,2474,261,358,840,1198,-11
Macon GA 2012,2012,Metropolitan Statistical Area,,,232840,-11,3188,2226,962,182,-1148,-966,-7
Madera CA 2012,2012,Metropolitan Statistical Area,,,152244,96,2376,1041,1335,153,-1427,-1274,35
Madison WI 2012,2012,Metropolitan Statistical Area,,,620401,6628,7340,3971,3369,1533,1704,3237,22
Manchester-Nashua NH 2012,2012,Metropolitan Statistical Area,,,402600,884,4309,2972,1337,941,-1405,-464,11
Manhattan KS 2012,2012,Metropolitan Statistical Area,,,98648,3224,1499,486,1013,1247,926,2173,38
Mankato-North Mankato MN 2012,2012,Metropolitan Statistical Area,,,97936,660,1145,665,480,107,81,188,-8
Mansfield OH 2012,2012,Metropolitan Statistical Area,,,122588,-482,1420,1323,97,22,-616,-594,15
McAllen-Edinburg-Mission TX 2012,2012,Metropolitan Statistical Area,,,807725,12422,16139,3697,12442,1556,-1559,-3,-17
Medford OR 2012,2012,Metropolitan Statistical Area,,,206363,1609,2254,2210,44,48,1547,1595,-30
Memphis TN-MS-AR 2012,2012,Metropolitan Statistical Area,,,1340755,7965,19258,10727,8531,1700,-2157,-457,-109
Merced CA 2012,2012,Metropolitan Statistical Area,,,261783,2085,4303,1570,2733,470,-1130,-660,12
Miami-Fort Lauderdale-West Palm Beach FL 2012,2012,Metropolitan Statistical Area,,,5789346,82454,66330,45443,20887,57539,3580,61119,448
Fort Lauderdale-Pompano Beach-Deerfield Beach FL 2012,2012,Metropolitan Division,,,1819773,31406,21165,14222,6943,14347,9905,24252,211
Miami-Miami Beach-Kendall FL 2012,2012,Metropolitan Division,,,2610960,31044,31134,18157,12977,35830,-17993,17837,230
West Palm Beach-Boca Raton-Delray Beach FL 2012,2012,Metropolitan Division,,,1358613,20004,14031,13064,967,7362,11668,19030,7
Michigan City-La Porte IN 2012,2012,Metropolitan Statistical Area,,,111158,-29,1301,1156,145,12,-183,-171,-3
Midland MI 2012,2012,Metropolitan Statistical Area,,,83649,-116,863,696,167,131,-422,-291,8
Midland TX 2012,2012,Metropolitan Statistical Area,,,152092,7096,2492,1018,1474,97,5387,5484,138
Milwaukee-Waukesha-West Allis WI 2012,2012,Metropolitan Statistical Area,,,1566755,5614,20184,12898,7286,2265,-3827,-1562,-110
Minneapolis-St. Paul-Bloomington MN-WI 2012,2012,Metropolitan Statistical Area,,,3423070,33921,44826,20810,24016,10619,-519,10100,-195
Missoula MT 2012,2012,Metropolitan Statistical Area,,,111054,933,1214,760,454,103,380,483,-4
Mobile AL 2012,2012,Metropolitan Statistical Area,,,413955,801,5676,4053,1623,698,-1526,-828,6
Modesto CA 2012,2012,Metropolitan Statistical Area,,,522134,3864,7697,3808,3889,1162,-1178,-16,-9
Monroe LA 2012,2012,Metropolitan Statistical Area,,,177885,495,2634,1671,963,163,-638,-475,7
Monroe MI 2012,2012,Metropolitan Statistical Area,,,150840,-659,1536,1387,149,66,-897,-831,23
Montgomery AL 2012,2012,Metropolitan Statistical Area,,,375874,-2086,4843,3290,1553,575,-4319,-3744,105
Morgantown WV 2012,2012,Metropolitan Statistical Area,,,134441,2127,1408,984,424,321,1349,1670,33
Morristown TN 2012,2012,Metropolitan Statistical Area,,,115042,242,1298,1239,59,70,108,178,5
Mount Vernon-Anacortes WA 2012,2012,Metropolitan Statistical Area,,,118005,265,1445,1105,340,102,-165,-63,-12
Muncie IN 2012,2012,Metropolitan Statistical Area,,,117309,-488,1222,1233,-11,122,-608,-486,9
Muskegon MI 2012,2012,Metropolitan Statistical Area,,,170146,160,2145,1665,480,81,-403,-322,2
Myrtle Beach-Conway-North Myrtle Beach SC-NC 2012,2012,Metropolitan Statistical Area,,,394128,8423,4096,3973,123,397,7888,8285,15
Napa CA 2012,2012,Metropolitan Statistical Area,,,139135,1079,1531,1135,396,439,255,694,-11
Naples-Immokalee-Marco Island FL 2012,2012,Metropolitan Statistical Area,,,332873,4970,3193,2970,223,1966,2868,4834,-87
Nashville-Davidson--Murfreesboro--Franklin TN 2012,2012,Metropolitan Statistical Area,,,1727153,28865,22674,12932,9742,3667,15229,18896,227
New Bern NC 2012,2012,Metropolitan Statistical Area,,,128630,389,1815,1209,606,761,-976,-215,-2
New Haven-Milford CT 2012,2012,Metropolitan Statistical Area,,,864031,-18,9044,7576,1468,3555,-5024,-1469,-17
New Orleans-Metairie LA 2012,2012,Metropolitan Statistical Area,,,1228375,14140,15411,10353,5058,3195,5709,8904,178
New York-Newark-Jersey City NY-NJ-PA 2012,2012,Metropolitan Statistical Area,,,19874606,118478,250731,137154,113577,134649,-127828,6821,-1920
Dutchess County-Putnam County NY 2012,2012,Metropolitan Division,,,396997,-1199,3503,2998,505,1033,-2754,-1721,17
Nassau County-Suffolk County NY 2012,2012,Metropolitan Division,,,2851345,3708,30229,22193,8036,8494,-12894,-4400,72
Newark NJ-PA 2012,2012,Metropolitan Division,,,2490087,6767,28159,18023,10136,13277,-16568,-3291,-78
New York-Jersey City-White Plains NY-NJ 2012,2012,Metropolitan Division,,,14136177,109202,188840,93940,94900,111845,-95612,16233,-1931
Niles-Benton Harbor MI 2012,2012,Metropolitan Statistical Area,,,156057,-487,1819,1675,144,306,-947,-641,10
North Port-Sarasota-Bradenton FL 2012,2012,Metropolitan Statistical Area,,,720121,11150,6410,8514,-2104,1741,11474,13215,39
Norwich-New London CT 2012,2012,Metropolitan Statistical Area,,,274544,488,2869,2317,552,1438,-1514,-76,12
Ocala FL 2012,2012,Metropolitan Statistical Area,,,334495,1988,3393,4426,-1033,602,2378,2980,41
Ocean City NJ 2012,2012,Metropolitan Statistical Area,,,96398,-164,975,1193,-218,229,-171,58,-4
Odessa TX 2012,2012,Metropolitan Statistical Area,,,144444,4754,2589,1108,1481,32,3174,3206,67
Ogden-Clearfield UT 2012,2012,Metropolitan Statistical Area,,,612629,6751,10692,3436,7256,805,-1296,-491,-14
Oklahoma City OK 2012,2012,Metropolitan Statistical Area,,,1297886,21028,18634,10737,7897,2796,10151,12947,184
Olympia-Tumwater WA 2012,2012,Metropolitan Statistical Area,,,258713,2232,3126,1928,1198,787,274,1061,-27
Omaha-Council Bluffs NE-IA 2012,2012,Metropolitan Statistical Area,,,885707,8728,13150,6264,6886,1984,-103,1881,-39
Orlando-Kissimmee-Sanford FL 2012,2012,Metropolitan Statistical Area,,,2225901,49813,26830,14698,12132,14901,22449,37350,331
Oshkosh-Neenah WI 2012,2012,Metropolitan Statistical Area,,,168634,1076,1925,1425,500,72,504,576,0
Owensboro KY 2012,2012,Metropolitan Statistical Area,,,115918,557,1581,1139,442,38,87,125,-10
Oxnard-Thousand Oaks-Ventura CA 2012,2012,Metropolitan Statistical Area,,,835476,4503,10528,5006,5522,1663,-2725,-1062,43
Palm Bay-Melbourne-Titusville FL 2012,2012,Metropolitan Statistical Area,,,547669,3238,5121,6114,-993,1193,3132,4325,-94
Panama City FL 2012,2012,Metropolitan Statistical Area,,,187664,2294,2417,1742,675,442,1169,1611,8
Parkersburg-Vienna WV 2012,2012,Metropolitan Statistical Area,,,92367,-220,942,1063,-121,15,-111,-96,-3
Pensacola-Ferry Pass-Brent FL 2012,2012,Metropolitan Statistical Area,,,462612,7273,5786,4319,1467,1806,3973,5779,27
Peoria IL 2012,2012,Metropolitan Statistical Area,,,380450,773,4822,3769,1053,396,-636,-240,-40
Philadelphia-Camden-Wilmington PA-NJ-DE-MD 2012,2012,Metropolitan Statistical Area,,,6020925,23842,72991,51741,21250,18504,-15555,2949,-357
Camden NJ 2012,2012,Metropolitan Division,,,1253982,827,14084,10254,3830,2991,-6051,-3060,57
Montgomery County-Bucks County-Chester County PA 2012,2012,Metropolitan Division,,,1942124,6642,20261,16054,4207,4143,-1675,2468,-33
Philadelphia PA 2012,2012,Metropolitan Division,,,2111312,12871,29996,19690,10306,9676,-6787,2889,-324
Wilmington DE-MD-NJ 2012,2012,Metropolitan Division,,,713507,3502,8650,5743,2907,1694,-1042,652,-57
Phoenix-Mesa-Scottsdale AZ 2012,2012,Metropolitan Statistical Area,,,4330974,76825,58823,28509,30314,9451,37097,46548,-37
Pine Bluff AR 2012,2012,Metropolitan Statistical Area,,,97344,-1657,1138,1044,94,4,-1788,-1784,33
Pittsburgh PA 2012,2012,Metropolitan Statistical Area,,,2361068,1388,23775,26819,-3044,2977,1596,4573,-141
Pittsfield MA 2012,2012,Metropolitan Statistical Area,,,130230,-345,1184,1405,-221,182,-307,-125,1
Pocatello ID 2012,2012,Metropolitan Statistical Area,,,83741,179,1288,658,630,74,-524,-450,-1
Portland-South Portland ME 2012,2012,Metropolitan Statistical Area,,,518219,2224,4940,4390,550,772,968,1740,-66
Portland-Vancouver-Hillsboro OR-WA 2012,2012,Metropolitan Statistical Area,,,2288729,28551,27541,15763,11778,4939,11765,16704,69
Port St. Lucie FL 2012,2012,Metropolitan Statistical Area,,,432405,4031,4181,4498,-317,903,3502,4405,-57
Prescott AZ 2012,2012,Metropolitan Statistical Area,,,212509,1324,1735,2600,-865,137,2084,2221,-32
Providence-Warwick RI-MA 2012,2012,Metropolitan Statistical Area,,,1603402,2257,16807,14231,2576,5051,-5361,-310,-9
Provo-Orem UT 2012,2012,Metropolitan Statistical Area,,,549930,9534,11726,2175,9551,784,-745,39,-56
Pueblo CO 2012,2012,Metropolitan Statistical Area,,,160840,627,1876,1582,294,77,252,329,4
Punta Gorda FL 2012,2012,Metropolitan Statistical Area,,,162792,3179,999,2189,-1190,243,4080,4323,46
Racine WI 2012,2012,Metropolitan Statistical Area,,,194683,-296,2425,1701,724,140,-1173,-1033,13
Raleigh NC 2012,2012,Metropolitan Statistical Area,,,1189075,25872,15157,6268,8889,3837,13008,16845,138
Rapid City SD 2012,2012,Metropolitan Statistical Area,,,138791,2437,1924,1024,900,279,1264,1543,-6
Reading PA 2012,2012,Metropolitan Statistical Area,,,413252,672,4878,3662,1216,1183,-1734,-551,7
Redding CA 2012,2012,Metropolitan Statistical Area,,,178421,471,2058,2067,-9,202,307,509,-29
Reno NV 2012,2012,Metropolitan Statistical Area,,,433001,4143,5227,3398,1829,703,1630,2333,-19
Richmond VA 2012,2012,Metropolitan Statistical Area,,,1233722,14130,14763,9632,5131,3717,5257,8974,25
Riverside-San Bernardino-Ontario CA 2012,2012,Metropolitan Statistical Area,,,4348670,46311,60257,26720,33537,8363,4552,12915,-141
Roanoke VA 2012,2012,Metropolitan Statistical Area,,,310710,1320,3337,3282,55,651,616,1267,-2
Rochester MN 2012,2012,Metropolitan Statistical Area,,,209709,1153,2815,1465,1350,603,-799,-196,-1
Rochester NY 2012,2012,Metropolitan Statistical Area,,,1083059,790,11640,9574,2066,2900,-4229,-1329,53
Rockford IL 2012,2012,Metropolitan Statistical Area,,,345803,-2087,4188,3008,1180,326,-3631,-3305,38
Rocky Mount NC 2012,2012,Metropolitan Statistical Area,,,151034,-811,1786,1554,232,46,-1112,-1066,23
Rome GA 2012,2012,Metropolitan Statistical Area,,,96066,-116,1127,1006,121,98,-338,-240,3
Sacramento--Roseville--Arden-Arcade CA 2012,2012,Metropolitan Statistical Area,,,2195087,19360,27151,15879,11272,6691,1607,8298,-210
Saginaw MI 2012,2012,Metropolitan Statistical Area,,,198268,-547,2372,2000,372,158,-1097,-939,20
St. Cloud MN 2012,2012,Metropolitan Statistical Area,,,190513,441,2432,1315,1117,238,-916,-678,2
St. George UT 2012,2012,Metropolitan Statistical Area,,,144643,3141,2163,1066,1097,60,2011,2071,-27
St. Joseph MO-KS 2012,2012,Metropolitan Statistical Area,,,127950,203,1614,1352,262,164,-212,-48,-11
St. Louis MO-IL 2012,2012,Metropolitan Statistical Area,,,2797281,3556,34279,24448,9831,4319,-10541,-6222,-53
Salem OR 2012,2012,Metropolitan Statistical Area,,,396339,2476,5235,3207,2028,387,101,488,-40
Salinas CA 2012,2012,Metropolitan Statistical Area,,,426411,5018,6808,2356,4452,1133,-499,634,-68
Salisbury MD-DE 2012,2012,Metropolitan Statistical Area,,,381407,3296,4190,3786,404,880,2020,2900,-8
Salt Lake City UT 2012,2012,Metropolitan Statistical Area,,,1124222,16588,18693,6317,12376,2875,1389,4264,-52
San Angelo TX 2012,2012,Metropolitan Statistical Area,,,115097,1668,1552,1010,542,317,802,1119,7
San Antonio-New Braunfels TX 2012,2012,Metropolitan Statistical Area,,,2237771,43540,30981,14778,16203,5589,21437,27026,311
San Diego-Carlsbad CA 2012,2012,Metropolitan Statistical Area,,,3183413,41645,43840,19887,23953,17028,769,17797,-105
San Francisco-Oakland-Hayward CA 2012,2012,Metropolitan Statistical Area,,,4462179,61997,51039,28297,22742,25916,13293,39209,46
Oakland-Hayward-Berkeley CA 2012,2012,Metropolitan Division,,,2635607,36502,30916,16194,14722,13946,7850,21796,-16
San Francisco-Redwood City-South San Francisco CA 2012,2012,Metropolitan Division,,,1570429,24765,17797,10230,7567,11139,5990,17129,69
San Rafael CA 2012,2012,Metropolitan Division,,,256143,730,2326,1873,453,831,-547,284,-7
San Jose-Sunnyvale-Santa Clara CA 2012,2012,Metropolitan Statistical Area,,,1897969,27690,24132,9600,14532,15764,-2299,13465,-307
San Luis Obispo-Paso Robles-Arroyo Grande CA 2012,2012,Metropolitan Statistical Area,,,274528,3363,2625,2263,362,205,2765,2970,31
Santa Cruz-Watsonville CA 2012,2012,Metropolitan Statistical Area,,,266632,1709,3162,1687,1475,343,-91,252,-18
Santa Fe NM 2012,2012,Metropolitan Statistical Area,,,146385,938,1373,1056,317,362,271,633,-12
Santa Maria-Santa Barbara CA 2012,2012,Metropolitan Statistical Area,,,430728,4754,5639,2862,2777,1283,699,1982,-5
Santa Rosa CA 2012,2012,Metropolitan Statistical Area,,,490838,3116,5045,3852,1193,589,1391,1980,-57
Savannah GA 2012,2012,Metropolitan Statistical Area,,,362293,6380,5223,2684,2539,1162,2616,3778,63
Scranton--Wilkes-Barre--Hazleton PA 2012,2012,Metropolitan Statistical Area,,,564134,221,5698,6789,-1091,1072,280,1352,-40
Seattle-Tacoma-Bellevue WA 2012,2012,Metropolitan Statistical Area,,,3553831,55811,44831,22384,22447,18404,14795,33199,165
Seattle-Bellevue-Everett WA 2012,2012,Metropolitan Division,,,2741468,46934,33387,16660,16727,15370,14586,29956,251
Tacoma-Lakewood WA 2012,2012,Metropolitan Division,,,812363,8877,11444,5724,5720,3034,209,3243,-86
Sebastian-Vero Beach FL 2012,2012,Metropolitan Statistical Area,,,140608,1635,1246,1714,-468,219,1915,2134,-31
Sebring FL 2012,2012,Metropolitan Statistical Area,,,98087,-273,901,1445,-544,214,60,274,-3
Sheboygan WI 2012,2012,Metropolitan Statistical Area,,,114952,-360,1250,1061,189,84,-645,-561,12
Sherman-Denison TX 2012,2012,Metropolitan Statistical Area,,,121631,348,1436,1347,89,125,140,265,-6
Shreveport-Bossier City LA 2012,2012,Metropolitan Statistical Area,,,448379,3358,6632,4319,2313,673,317,990,55
Sierra Vista-Douglas AZ 2012,2012,Metropolitan Statistical Area,,,131919,-1139,1690,1215,475,488,-2121,-1633,19
Sioux City IA-NE-SD 2012,2012,Metropolitan Statistical Area,,,168796,-144,2462,1513,949,268,-1383,-1115,22
Sioux Falls SD 2012,2012,Metropolitan Statistical Area,,,237748,5098,3780,1679,2101,719,2254,2973,24
South Bend-Mishawaka IN-MI 2012,2012,Metropolitan Statistical Area,,,318625,-597,3973,3022,951,482,-2061,-1579,31
Spartanburg SC 2012,2012,Metropolitan Statistical Area,,,316643,1896,3873,3142,731,176,1009,1185,-20
Spokane-Spokane Valley WA 2012,2012,Metropolitan Statistical Area,,,532312,2475,6382,4555,1827,827,-131,696,-48
Springfield IL 2012,2012,Metropolitan Statistical Area,,,211956,322,2465,1976,489,195,-346,-151,-16
Springfield MA 2012,2012,Metropolitan Statistical Area,,,626890,815,6546,5355,1191,3441,-3836,-395,19
Springfield MO 2012,2012,Metropolitan Statistical Area,,,444681,4316,5537,3868,1669,305,2344,2649,-2
Springfield OH 2012,2012,Metropolitan Statistical Area,,,137194,-544,1597,1697,-100,71,-526,-455,11
State College PA 2012,2012,Metropolitan Statistical Area,,,155582,735,1313,925,388,811,-475,336,11
Staunton-Waynesboro VA 2012,2012,Metropolitan Statistical Area,,,118629,-275,1261,1263,-2,49,-315,-266,-7
Stockton-Lodi CA 2012,2012,Metropolitan Statistical Area,,,701635,6156,10084,4974,5110,1521,-447,1074,-28
Sumter SC 2012,2012,Metropolitan Statistical Area,,,108060,710,1568,980,588,236,-103,133,-11
Syracuse NY 2012,2012,Metropolitan Statistical Area,,,661256,-1353,7487,5731,1756,1668,-4832,-3164,55
Tallahassee FL 2012,2012,Metropolitan Statistical Area,,,375523,4367,4005,2518,1487,768,1984,2752,128
Tampa-St. Petersburg-Clearwater FL 2012,2012,Metropolitan Statistical Area,,,2848003,18899,30869,28177,2692,10645,5472,16117,90
Terre Haute IN 2012,2012,Metropolitan Statistical Area,,,172626,45,1978,1822,156,190,-289,-99,-12
Texarkana TX-AR 2012,2012,Metropolitan Statistical Area,,,149610,49,1961,1515,446,36,-427,-391,-6
The Villages FL 2012,2012,Metropolitan Statistical Area,,,102823,4225,437,1301,-864,69,5172,5241,-152
Toledo OH 2012,2012,Metropolitan Statistical Area,,,608551,-1045,7499,5656,1843,699,-3670,-2971,83
Topeka KS 2012,2012,Metropolitan Statistical Area,,,234444,-227,2989,2300,689,162,-1093,-931,15
Trenton NJ 2012,2012,Metropolitan Statistical Area,,,369057,1116,4239,2798,1441,2353,-2679,-326,1
Tucson AZ 2012,2012,Metropolitan Statistical Area,,,993094,4969,11821,8711,3110,2266,-266,2000,-141
Tulsa OK 2012,2012,Metropolitan Statistical Area,,,952836,6909,13337,8631,4706,1055,1190,2245,-42
Tuscaloosa AL 2012,2012,Metropolitan Statistical Area,,,233377,1977,2875,1980,895,233,838,1071,11
Tyler TX 2012,2012,Metropolitan Statistical Area,,,214941,2176,2976,1947,1029,210,954,1164,-17
Urban Honolulu HI 2012,2012,Metropolitan Statistical Area,,,976746,10187,13511,7125,6386,7802,-3901,3901,-100
Utica-Rome NY 2012,2012,Metropolitan Statistical Area,,,298553,-293,3337,3099,238,723,-1275,-552,21
Valdosta GA 2012,2012,Metropolitan Statistical Area,,,144614,2200,2082,995,1087,353,709,1062,51
Vallejo-Fairfield CA 2012,2012,Metropolitan Statistical Area,,,420724,3779,5068,2919,2149,1732,-70,1662,-32
Victoria TX 2012,2012,Metropolitan Statistical Area,,,96614,1964,1347,882,465,80,1394,1474,25
Vineland-Bridgeton NJ 2012,2012,Metropolitan Statistical Area,,,157794,187,2198,1407,791,467,-1059,-592,-12
Virginia Beach-Norfolk-Newport News VA-NC 2012,2012,Metropolitan Statistical Area,,,1698391,11409,22834,12685,10149,7610,-6378,1232,28
Visalia-Porterville CA 2012,2012,Metropolitan Statistical Area,,,451499,3675,8021,2793,5228,295,-1850,-1555,2
Waco TX 2012,2012,Metropolitan Statistical Area,,,257111,1382,3649,2156,1493,265,-359,-94,-17
Walla Walla WA 2012,2012,Metropolitan Statistical Area,,,63459,-86,711,567,144,63,-303,-240,10
Warner Robins GA 2012,2012,Metropolitan Statistical Area,,,185390,1801,2515,1310,1205,483,119,602,-6
Washington-Arlington-Alexandria DC-VA-MD-WV 2012,2012,Metropolitan Statistical Area,,,5873480,95759,80183,30918,49265,41334,5418,46752,-258
Silver Spring-Frederick-Rockville MD 2012,2012,Metropolitan Division,,,1246215,16139,15756,7237,8519,10239,-2498,7741,-121
Washington-Arlington-Alexandria DC-VA-MD-WV 2012,2012,Metropolitan Division,,,4627265,79620,64427,23681,40746,31095,7916,39011,-137
Waterloo-Cedar Falls IA 2012,2012,Metropolitan Statistical Area,,,168547,297,2051,1486,565,176,-428,-252,-16
Watertown-Fort Drum NY 2012,2012,Metropolitan Statistical Area,,,120916,2643,2201,878,1323,1269,48,1317,3
Wausau WI 2012,2012,Metropolitan Statistical Area,,,134689,158,1625,1139,486,107,-443,-336,8
Weirton-Steubenville WV-OH 2012,2012,Metropolitan Statistical Area,,,122466,-858,1096,1756,-660,3,-189,-186,-12
Wenatchee WA 2012,2012,Metropolitan Statistical Area,,,112995,904,1455,953,502,77,330,407,-5
Wheeling WV-OH 2012,2012,Metropolitan Statistical Area,,,146364,-711,1455,1945,-490,39,-250,-211,-10
Wichita KS 2012,2012,Metropolitan Statistical Area,,,635942,2676,9260,5375,3885,1007,-2212,-1205,-4
Wichita Falls TX 2012,2012,Metropolitan Statistical Area,,,150986,654,1927,1484,443,659,-439,220,-9
Williamsport PA 2012,2012,Metropolitan Statistical Area,,,117296,627,1305,1211,94,70,458,528,5
Wilmington NC 2012,2012,Metropolitan Statistical Area,,,263101,3767,2855,2128,727,277,2728,3005,35
Winchester VA-WV 2012,2012,Metropolitan Statistical Area,,,131017,970,1485,1082,403,111,475,586,-19
Winston-Salem NC 2012,2012,Metropolitan Statistical Area,,,647687,3036,7507,5886,1621,826,612,1438,-23
Worcester MA-CT 2012,2012,Metropolitan Statistical Area,,,924072,1848,9907,7478,2429,3551,-4141,-590,9
Yakima WA 2012,2012,Metropolitan Statistical Area,,,246721,562,4110,1816,2294,73,-1833,-1760,28
York-Hanover PA 2012,2012,Metropolitan Statistical Area,,,437699,831,4901,3679,1222,596,-985,-389,-2
Youngstown-Warren-Boardman OH-PA 2012,2012,Metropolitan Statistical Area,,,558973,-3514,5457,6944,-1487,258,-2332,-2074,47
Yuba City CA 2012,2012,Metropolitan Statistical Area,,,167614,264,2536,1265,1271,682,-1720,-1038,31
Yuma AZ 2012,2012,Metropolitan Statistical Area,,,202264,-353,3235,1436,1799,586,-2795,-2209,57
Abilene TX 2013,2013,Metropolitan Statistical Area,,,167452,-77,2359,1642,717,336,-1161,-825,31
Akron OH 2013,2013,Metropolitan Statistical Area,,,703210,1007,7666,6862,804,1130,-966,164,39
Albany GA 2013,2013,Metropolitan Statistical Area,,,155790,-1565,2163,1481,682,101,-2310,-2209,-38
Albany OR 2013,2013,Metropolitan Statistical Area,,,118644,284,1425,1121,304,42,-100,-58,38
Albany-Schenectady-Troy NY 2013,2013,Metropolitan Statistical Area,,,878479,3209,9195,7551,1644,2485,-769,1716,-151
Albuquerque NM 2013,2013,Metropolitan Statistical Area,,,903345,2329,10775,7080,3695,1153,-2809,-1656,290
Alexandria LA 2013,2013,Metropolitan Statistical Area,,,154903,416,2039,1650,389,165,-121,44,-17
Allentown-Bethlehem-Easton PA-NJ 2013,2013,Metropolitan Statistical Area,,,827044,-65,8496,7708,788,2427,-3532,-1105,252
Altoona PA 2013,2013,Metropolitan Statistical Area,,,126379,-620,1325,1643,-318,37,-392,-355,53
Amarillo TX 2013,2013,Metropolitan Statistical Area,,,258833,1078,3908,2271,1637,676,-1306,-630,71
Ames IA 2013,2013,Metropolitan Statistical Area,,,93410,1689,963,452,511,694,510,1204,-26
Anchorage AK 2013,2013,Metropolitan Statistical Area,,,397521,5090,6029,2216,3813,1348,93,1441,-164
Ann Arbor MI 2013,2013,Metropolitan Statistical Area,,,354418,3117,3664,2064,1600,2119,-635,1484,33
Anniston-Oxford-Jacksonville AL 2013,2013,Metropolitan Statistical Area,,,116547,-717,1327,1418,-91,33,-643,-610,-16
Appleton WI 2013,2013,Metropolitan Statistical Area,,,229869,1288,2785,1542,1243,192,-222,-30,75
Asheville NC 2013,2013,Metropolitan Statistical Area,,,437661,5519,4436,4735,-299,401,5151,5552,266
Athens-Clarke County GA 2013,2013,Metropolitan Statistical Area,,,197884,1479,2215,1356,859,480,139,619,1
Atlanta-Sandy Springs-Roswell GA 2013,2013,Metropolitan Statistical Area,,,5525432,68960,71753,34204,37549,18664,12061,30725,686
Atlantic City-Hammonton NJ 2013,2013,Metropolitan Statistical Area,,,276167,601,3372,2574,798,1507,-1648,-141,-56
Auburn-Opelika AL 2013,2013,Metropolitan Statistical Area,,,151708,3668,1808,1043,765,624,2221,2845,58
Augusta-Richmond County GA-SC 2013,2013,Metropolitan Statistical Area,,,580230,3475,7158,5240,1918,959,366,1325,232
Austin-Round Rock TX 2013,2013,Metropolitan Statistical Area,,,1885803,49654,25421,9013,16408,6386,26768,33154,92
Bakersfield CA 2013,2013,Metropolitan Statistical Area,,,865923,9421,14741,5727,9014,1816,-1266,550,-143
Baltimore-Columbia-Towson MD 2013,2013,Metropolitan Statistical Area,,,2774050,17819,33688,24099,9589,9708,-1513,8195,35
Bangor ME 2013,2013,Metropolitan Statistical Area,,,153479,-133,1444,1528,-84,160,-289,-129,80
Barnstable Town MA 2013,2013,Metropolitan Statistical Area,,,214836,-9,1559,2816,-1257,348,699,1047,201
Baton Rouge LA 2013,2013,Metropolitan Statistical Area,,,820409,5416,11050,6723,4327,1307,-312,995,94
Battle Creek MI 2013,2013,Metropolitan Statistical Area,,,134830,70,1694,1452,242,202,-423,-221,49
Bay City MI 2013,2013,Metropolitan Statistical Area,,,106936,-148,1063,1121,-58,42,-137,-95,5
Beaumont-Port Arthur TX 2013,2013,Metropolitan Statistical Area,,,405424,1592,5496,4114,1382,587,-376,211,-1
Beckley WV 2013,2013,Metropolitan Statistical Area,,,124196,-824,1511,1699,-188,93,-756,-663,27
Bellingham WA 2013,2013,Metropolitan Statistical Area,,,206248,1421,2261,1577,684,336,375,711,26
Bend-Redmond OR 2013,2013,Metropolitan Statistical Area,,,165955,4209,1686,1339,347,-9,4114,4105,-243
Billings MT 2013,2013,Metropolitan Statistical Area,,,165222,2383,2058,1470,588,49,1609,1658,137
Binghamton NY 2013,2013,Metropolitan Statistical Area,,,248362,-643,2573,2529,44,492,-1162,-670,-17
Birmingham-Hoover AL 2013,2013,Metropolitan Statistical Area,,,1139556,5259,14446,11346,3100,1225,1095,2320,-161
Bismarck ND 2013,2013,Metropolitan Statistical Area,,,123993,3700,1793,996,797,24,2829,2853,50
Blacksburg-Christiansburg-Radford VA 2013,2013,Metropolitan Statistical Area,,,180952,1394,1731,1506,225,762,470,1232,-63
Bloomington IL 2013,2013,Metropolitan Statistical Area,,,191294,2384,2369,1340,1029,589,736,1325,30
Bloomington IN 2013,2013,Metropolitan Statistical Area,,,163190,538,1507,1092,415,945,-846,99,24
Bloomsburg-Berwick PA 2013,2013,Metropolitan Statistical Area,,,85674,259,878,890,-12,165,109,274,-3
Boise City ID 2013,2013,Metropolitan Statistical Area,,,650457,12806,8644,4163,4481,923,7723,8646,-321
Boston-Cambridge-Newton MA-NH 2013,2013,Metropolitan Statistical Area,,,4698049,47381,52291,34876,17415,29173,1430,30603,-637
Boston MA 2013,2013,Metropolitan Division,,,1952438,21109,22090,14529,7561,13319,586,13905,-357
Cambridge-Newton-Framingham MA 2013,2013,Metropolitan Division,,,2322224,25269,26371,17271,9100,15505,1044,16549,-380
Rockingham County-Strafford County NH 2013,2013,Metropolitan Division,,,423387,1003,3830,3076,754,349,-200,149,100
Boulder CO 2013,2013,Metropolitan Statistical Area,,,310396,4913,2979,1694,1285,912,2746,3658,-30
Bowling Green KY 2013,2013,Metropolitan Statistical Area,,,163841,1489,2021,1348,673,509,340,849,-33
Bremerton-Silverdale WA 2013,2013,Metropolitan Statistical Area,,,253205,-1454,2858,1971,887,434,-2962,-2528,187
Bridgeport-Stamford-Norwalk CT 2013,2013,Metropolitan Statistical Area,,,942119,6829,10042,6667,3375,6129,-1941,4188,-734
Brownsville-Harlingen TX 2013,2013,Metropolitan Statistical Area,,,418217,2169,7372,2494,4878,707,-3717,-3010,301
Brunswick GA 2013,2013,Metropolitan Statistical Area,,,114012,575,1440,1128,312,108,125,233,30
Buffalo-Cheektowaga-Niagara Falls NY 2013,2013,Metropolitan Statistical Area,,,1136153,1086,12171,11725,446,3219,-2128,1091,-451
Burlington NC 2013,2013,Metropolitan Statistical Area,,,154685,1013,1774,1578,196,144,569,713,104
Burlington-South Burlington VT 2013,2013,Metropolitan Statistical Area,,,215072,1198,2217,1409,808,467,-86,381,9
California-Lexington Park MD 2013,2013,Metropolitan Statistical Area,,,109484,485,1392,798,594,196,-316,-120,11
Canton-Massillon OH 2013,2013,Metropolitan Statistical Area,,,403493,89,4346,4221,125,236,-105,131,-167
Cape Coral-Fort Myers FL 2013,2013,Metropolitan Statistical Area,,,661336,16348,6352,6219,133,2906,13521,16427,-212
Cape Girardeau MO-IL 2013,2013,Metropolitan Statistical Area,,,97617,382,1135,904,231,116,23,139,12
Carbondale-Marion IL 2013,2013,Metropolitan Statistical Area,,,127069,85,1426,1154,272,326,-467,-141,-46
Carson City NV 2013,2013,Metropolitan Statistical Area,,,54061,-517,576,649,-73,4,-503,-499,55
Casper WY 2013,2013,Metropolitan Statistical Area,,,81143,2457,1138,688,450,43,1941,1984,23
Cedar Rapids IA 2013,2013,Metropolitan Statistical Area,,,262348,662,3193,2041,1152,332,-759,-427,-63
Chambersburg-Waynesboro PA 2013,2013,Metropolitan Statistical Area,,,152191,602,1770,1453,317,214,-37,177,108
Champaign-Urbana IL 2013,2013,Metropolitan Statistical Area,,,236015,1501,2647,1580,1067,1910,-1478,432,2
Charleston WV 2013,2013,Metropolitan Statistical Area,,,224683,-1117,2556,2838,-282,72,-777,-705,-130
Charleston-North Charleston SC 2013,2013,Metropolitan Statistical Area,,,712081,14646,9189,5099,4090,1161,8918,10079,477
Charlotte-Concord-Gastonia NC-SC 2013,2013,Metropolitan Statistical Area,,,2337339,41460,29395,17371,12024,5709,22501,28210,1226
Charlottesville VA 2013,2013,Metropolitan Statistical Area,,,224778,1627,2441,1684,757,877,16,893,-23
Chattanooga TN-GA 2013,2013,Metropolitan Statistical Area,,,542161,4164,6320,5357,963,598,2592,3190,11
Cheyenne WY 2013,2013,Metropolitan Statistical Area,,,96015,1166,1272,733,539,129,448,577,50
Chicago-Naperville-Elgin IL-IN-WI 2013,2013,Metropolitan Statistical Area,,,9544796,25480,119903,69487,50416,27216,-49798,-22582,-2354
Chicago-Naperville-Arlington Heights IL 2013,2013,Metropolitan Division,,,7338906,21376,93895,53425,40470,23951,-40294,-16343,-2751
Elgin IL 2013,2013,Metropolitan Division,,,629079,2543,7903,3834,4069,877,-2723,-1846,320
Gary IN 2013,2013,Metropolitan Division,,,705290,-1095,8206,6596,1610,398,-2904,-2506,-199
Lake County-Kenosha County IL-WI 2013,2013,Metropolitan Division,,,871521,2656,9899,5632,4267,1990,-3877,-1887,276
Chico CA 2013,2013,Metropolitan Statistical Area,,,222420,1141,2377,2275,102,269,606,875,164
Cincinnati OH-KY-IN 2013,2013,Metropolitan Statistical Area,,,2138536,8750,27767,18340,9427,3604,-3833,-229,-448
Clarksville TN-KY 2013,2013,Metropolitan Statistical Area,,,273453,-2069,5266,1948,3318,1242,-6781,-5539,152
Cleveland TN 2013,2013,Metropolitan Statistical Area,,,118537,807,1304,1134,170,119,473,592,45
Cleveland-Elyria OH 2013,2013,Metropolitan Statistical Area,,,2065328,758,22964,20509,2455,3960,-4794,-834,-863
Coeur d'Alene ID 2013,2013,Metropolitan Statistical Area,,,144357,2060,1739,1190,549,46,1562,1608,-97
College Station-Bryan TX 2013,2013,Metropolitan Statistical Area,,,238245,3872,3008,1271,1737,1512,587,2099,36
Colorado Springs CO 2013,2013,Metropolitan Statistical Area,,,678711,9611,9292,4255,5037,1865,2419,4284,290
Columbia MO 2013,2013,Metropolitan Statistical Area,,,170929,2337,2160,1043,1117,661,468,1129,91
Columbia SC 2013,2013,Metropolitan Statistical Area,,,792422,8143,9405,6461,2944,1632,3168,4800,399
Columbus GA-AL 2013,2013,Metropolitan Statistical Area,,,317126,5415,4665,2672,1993,932,2374,3306,116
Columbus IN 2013,2013,Metropolitan Statistical Area,,,79549,646,1082,668,414,257,-35,222,10
Columbus OH 2013,2013,Metropolitan Statistical Area,,,1969032,23373,26914,15033,11881,5351,6092,11443,49
Corpus Christi TX 2013,2013,Metropolitan Statistical Area,,,443448,6436,6131,3782,2349,761,3316,4077,10
Corvallis OR 2013,2013,Metropolitan Statistical Area,,,85960,-420,711,518,193,383,-1023,-640,27
Crestview-Fort Walton Beach-Destin FL 2013,2013,Metropolitan Statistical Area,,,253309,5597,3360,2167,1193,756,3642,4398,6
Cumberland MD-WV 2013,2013,Metropolitan Statistical Area,,,101238,-578,993,1224,-231,48,-383,-335,-12
Dallas-Fort Worth-Arlington TX 2013,2013,Metropolitan Statistical Area,,,6823113,113047,96576,40187,56389,24332,33313,57645,-987
Dallas-Plano-Irving TX 2013,2013,Metropolitan Division,,,4511487,78647,64229,25125,39104,18155,22771,40926,-1383
Fort Worth-Arlington TX 2013,2013,Metropolitan Division,,,2311626,34400,32347,15062,17285,6177,10542,16719,396
Dalton GA 2013,2013,Metropolitan Statistical Area,,,142385,-196,1897,1187,710,104,-1066,-962,56
Danville IL 2013,2013,Metropolitan Statistical Area,,,80418,-346,1061,909,152,24,-466,-442,-56
Daphne-Fairhope-Foley AL 2013,2013,Metropolitan Statistical Area,,,195443,4882,2162,1912,250,284,4244,4528,104
Davenport-Moline-Rock Island IA-IL 2013,2013,Metropolitan Statistical Area,,,383230,1091,4650,3576,1074,534,-458,76,-59
Dayton OH 2013,2013,Metropolitan Statistical Area,,,801645,-589,9560,7950,1610,1523,-3736,-2213,14
Decatur AL 2013,2013,Metropolitan Statistical Area,,,153199,-634,1762,1598,164,112,-937,-825,27
Decatur IL 2013,2013,Metropolitan Statistical Area,,,109435,-608,1368,1190,178,84,-853,-769,-17
Deltona-Daytona Beach-Ormond Beach FL 2013,2013,Metropolitan Statistical Area,,,601151,5549,5431,7632,-2201,1183,6276,7459,291
Denver-Aurora-Lakewood CO 2013,2013,Metropolitan Statistical Area,,,2699750,51970,34959,16525,18434,6229,26612,32841,695
Des Moines-West Des Moines IA 2013,2013,Metropolitan Statistical Area,,,600086,10633,8717,4129,4588,1537,4418,5955,90
Detroit-Warren-Dearborn MI 2013,2013,Metropolitan Statistical Area,,,4295394,2482,50115,38844,11271,11186,-18601,-7415,-1374
Detroit-Dearborn-Livonia MI 2013,2013,Metropolitan Division,,,1775703,-17067,23389,17075,6314,4062,-25555,-21493,-1888
Warren-Troy-Farmington Hills MI 2013,2013,Metropolitan Division,,,2519691,19549,26726,21769,4957,7124,6954,14078,514
Dothan AL 2013,2013,Metropolitan Statistical Area,,,147592,-26,1727,1653,74,63,-152,-89,-11
Dover DE 2013,2013,Metropolitan Statistical Area,,,169562,1896,2195,1543,652,416,892,1308,-64
Dubuque IA 2013,2013,Metropolitan Statistical Area,,,95912,765,1191,882,309,80,362,442,14
Duluth MN-WI 2013,2013,Metropolitan Statistical Area,,,279942,328,2873,2831,42,225,28,253,33
Durham-Chapel Hill NC 2013,2013,Metropolitan Statistical Area,,,533622,8596,6519,3576,2943,2217,3316,5533,120
East Stroudsburg PA 2013,2013,Metropolitan Statistical Area,,,167130,-1335,1443,1385,58,197,-1558,-1361,-32
Eau Claire WI 2013,2013,Metropolitan Statistical Area,,,164903,1012,1860,1272,588,94,275,369,55
El Centro CA 2013,2013,Metropolitan Statistical Area,,,177517,74,3059,915,2144,269,-2442,-2173,103
Elizabethtown-Fort Knox KY 2013,2013,Metropolitan Statistical Area,,,151395,982,1986,1217,769,395,-193,202,11
Elkhart-Goshen IN 2013,2013,Metropolitan Statistical Area,,,200591,1355,3026,1520,1506,140,-262,-122,-29
Elmira NY 2013,2013,Metropolitan Statistical Area,,,88485,-746,1036,943,93,78,-989,-911,72
El Paso TX 2013,2013,Metropolitan Statistical Area,,,834630,153,13715,4811,8904,2258,-11437,-9179,428
Erie PA 2013,2013,Metropolitan Statistical Area,,,279760,-1041,3081,2772,309,439,-1750,-1311,-39
Eugene OR 2013,2013,Metropolitan Statistical Area,,,355661,1180,3485,3270,215,692,91,783,182
Evansville IN-KY 2013,2013,Metropolitan Statistical Area,,,314429,1131,3848,3128,720,218,277,495,-84
Fairbanks AK 2013,2013,Metropolitan Statistical Area,,,100807,580,1644,448,1196,399,-905,-506,-110
Fargo ND-MN 2013,2013,Metropolitan Statistical Area,,,223853,6801,3206,1356,1850,709,4156,4865,86
Farmington NM 2013,2013,Metropolitan Statistical Area,,,126448,-1919,1861,993,868,25,-2903,-2878,91
Fayetteville NC 2013,2013,Metropolitan Statistical Area,,,377619,4053,6672,2711,3961,1843,-1902,-59,151
Fayetteville-Springdale-Rogers AR-MO 2013,2013,Metropolitan Statistical Area,,,492375,9346,7071,3250,3821,1430,3933,5363,162
Flagstaff AZ 2013,2013,Metropolitan Statistical Area,,,136690,741,1680,751,929,124,-375,-251,63
Flint MI 2013,2013,Metropolitan Statistical Area,,,415623,-2435,4874,4360,514,256,-3408,-3152,203
Florence SC 2013,2013,Metropolitan Statistical Area,,,206380,155,2572,2285,287,134,-201,-67,-65
Florence-Muscle Shoals AL 2013,2013,Metropolitan Statistical Area,,,147273,106,1539,1832,-293,92,279,371,28
Fond du Lac WI 2013,2013,Metropolitan Statistical Area,,,101648,-54,1106,887,219,82,-372,-290,17
Fort Collins CO 2013,2013,Metropolitan Statistical Area,,,316494,5659,3390,1971,1419,407,3739,4146,94
Fort Smith AR-OK 2013,2013,Metropolitan Statistical Area,,,279930,-774,3714,2984,730,146,-1667,-1521,17
Fort Wayne IN 2013,2013,Metropolitan Statistical Area,,,424570,2790,6007,3415,2592,854,-625,229,-31
Fresno CA 2013,2013,Metropolitan Statistical Area,,,956102,7862,15933,6641,9292,2088,-3764,-1676,246
Gadsden AL 2013,2013,Metropolitan Statistical Area,,,103962,-362,1152,1352,-200,63,-199,-136,-26
Gainesville FL 2013,2013,Metropolitan Statistical Area,,,270216,1631,3023,2004,1019,1362,-896,466,146
Gainesville GA 2013,2013,Metropolitan Statistical Area,,,187759,2675,2467,1312,1155,277,1370,1647,-127
Gettysburg PA 2013,2013,Metropolitan Statistical Area,,,101457,-81,1032,990,42,59,-270,-211,88
Glens Falls NY 2013,2013,Metropolitan Statistical Area,,,127898,-578,1154,1257,-103,48,-534,-486,11
Goldsboro NC 2013,2013,Metropolitan Statistical Area,,,124596,92,1750,1114,636,338,-874,-536,-8
Grand Forks ND-MN 2013,2013,Metropolitan Statistical Area,,,101014,1800,1363,797,566,344,832,1176,58
Grand Island NE 2013,2013,Metropolitan Statistical Area,,,84187,725,1212,705,507,351,-131,220,-2
Grand Junction CO 2013,2013,Metropolitan Statistical Area,,,147699,-25,1853,1418,435,66,-617,-551,91
Grand Rapids-Wyoming MI 2013,2013,Metropolitan Statistical Area,,,1017247,11116,13659,7169,6490,1538,2593,4131,495
Grants Pass OR 2013,2013,Metropolitan Statistical Area,,,83271,489,832,1151,-319,7,700,707,101
Great Falls MT 2013,2013,Metropolitan Statistical Area,,,82404,639,1184,779,405,168,33,201,33
Greeley CO 2013,2013,Metropolitan Statistical Area,,,270560,6371,3907,1557,2350,314,3540,3854,167
Green Bay WI 2013,2013,Metropolitan Statistical Area,,,312573,1521,3965,2229,1736,407,-687,-280,65
Greensboro-High Point NC 2013,2013,Metropolitan Statistical Area,,,741314,5448,8769,6616,2153,1650,1237,2887,408
Greenville NC 2013,2013,Metropolitan Statistical Area,,,174351,1456,2164,1167,997,228,192,420,39
Greenville-Anderson-Mauldin SC 2013,2013,Metropolitan Statistical Area,,,850406,8369,10339,7875,2464,1501,3821,5322,583
Gulfport-Biloxi-Pascagoula MS 2013,2013,Metropolitan Statistical Area,,,382458,3488,4724,3537,1187,747,1512,2259,42
Hagerstown-Martinsburg MD-WV 2013,2013,Metropolitan Statistical Area,,,257950,1726,3184,2418,766,303,561,864,96
Hammond LA 2013,2013,Metropolitan Statistical Area,,,125508,1741,1922,1188,734,114,828,942,65
Hanford-Corcoran CA 2013,2013,Metropolitan Statistical Area,,,150862,-478,2396,788,1608,377,-2458,-2081,-5
Harrisburg-Carlisle PA 2013,2013,Metropolitan Statistical Area,,,557906,3079,6540,4945,1595,1459,90,1549,-65
Harrisonburg VA 2013,2013,Metropolitan Statistical Area,,,129233,634,1391,928,463,446,-318,128,43
Hartford-West Hartford-East Hartford CT 2013,2013,Metropolitan Statistical Area,,,1215943,800,11960,10202,1758,5512,-5828,-316,-642
Hattiesburg MS 2013,2013,Metropolitan Statistical Area,,,147846,1133,2060,1206,854,117,125,242,37
Hickory-Lenoir-Morganton NC 2013,2013,Metropolitan Statistical Area,,,363373,-338,3727,3841,-114,290,-640,-350,126
Hilton Head Island-Bluffton-Beaufort SC 2013,2013,Metropolitan Statistical Area,,,198279,4524,2377,1607,770,686,3194,3880,-126
Hinesville GA 2013,2013,Metropolitan Statistical Area,,,80698,-854,1689,390,1299,417,-2657,-2240,87
Homosassa Springs FL 2013,2013,Metropolitan Statistical Area,,,139134,-156,1026,2410,-1384,89,938,1027,201
Hot Springs AR 2013,2013,Metropolitan Statistical Area,,,97065,228,1124,1323,-199,17,686,703,-276
Houma-Thibodaux LA 2013,2013,Metropolitan Statistical Area,,,209963,1107,2690,1856,834,269,-7,262,11
Houston-The Woodlands-Sugar Land TX 2013,2013,Metropolitan Statistical Area,,,6333809,146886,93785,36355,57430,31910,56747,88657,799
Huntington-Ashland WV-KY-OH 2013,2013,Metropolitan Statistical Area,,,364189,-755,4195,4118,77,161,-837,-676,-156
Huntsville AL 2013,2013,Metropolitan Statistical Area,,,435997,5766,4981,3431,1550,658,3288,3946,270
Idaho Falls ID 2013,2013,Metropolitan Statistical Area,,,137046,787,2464,939,1525,56,-850,-794,56
Indianapolis-Carmel-Anderson IN 2013,2013,Metropolitan Statistical Area,,,1953146,24363,26557,15145,11412,4340,8948,13288,-337
Iowa City IA 2013,2013,Metropolitan Statistical Area,,,161829,2995,2066,868,1198,910,842,1752,45
Ithaca NY 2013,2013,Metropolitan Statistical Area,,,104368,1324,966,617,349,1105,-123,982,-7
Jackson MI 2013,2013,Metropolitan Statistical Area,,,159909,-247,1755,1598,157,110,-542,-432,28
Jackson MS 2013,2013,Metropolitan Statistical Area,,,577219,320,7477,5113,2364,517,-2348,-1831,-213
Jackson TN 2013,2013,Metropolitan Statistical Area,,,130718,340,1665,1257,408,80,-141,-61,-7
Jacksonville FL 2013,2013,Metropolitan Statistical Area,,,1396046,17212,17597,12019,5578,3819,7460,11279,355
Jacksonville NC 2013,2013,Metropolitan Statistical Area,,,185669,1781,4503,933,3570,1532,-3432,-1900,111
Janesville-Beloit WI 2013,2013,Metropolitan Statistical Area,,,160633,362,1878,1432,446,50,-98,-48,-36
Jefferson City MO 2013,2013,Metropolitan Statistical Area,,,150638,272,1829,1208,621,152,-443,-291,-58
Johnson City TN 2013,2013,Metropolitan Statistical Area,,,200969,445,2091,2228,-137,110,354,464,118
Johnstown PA 2013,2013,Metropolitan Statistical Area,,,138900,-2631,1328,1776,-448,64,-2296,-2232,49
Jonesboro AR 2013,2013,Metropolitan Statistical Area,,,125869,1641,1745,1149,596,138,873,1011,34
Joplin MO 2013,2013,Metropolitan Statistical Area,,,175209,764,2405,1764,641,170,-28,142,-19
Kahului-Wailuku-Lahaina HI 2013,2013,Metropolitan Statistical Area,,,160880,2359,2020,1166,854,712,697,1409,96
Kalamazoo-Portage MI 2013,2013,Metropolitan Statistical Area,,,332557,2287,4087,2635,1452,606,170,776,59
Kankakee IL 2013,2013,Metropolitan Statistical Area,,,112193,-733,1331,1094,237,86,-1085,-999,29
Kansas City MO-KS 2013,2013,Metropolitan Statistical Area,,,2055351,16138,27814,16133,11681,3601,733,4334,123
Kennewick-Richland WA 2013,2013,Metropolitan Statistical Area,,,271067,2840,4147,1591,2556,343,-137,206,78
Killeen-Temple TX 2013,2013,Metropolitan Statistical Area,,,423282,2918,7638,2536,5102,2030,-4337,-2307,123
Kingsport-Bristol-Bristol TN-VA 2013,2013,Metropolitan Statistical Area,,,308356,-516,3099,3810,-711,62,36,98,97
Kingston NY 2013,2013,Metropolitan Statistical Area,,,180848,-860,1539,1535,4,354,-1164,-810,-54
Knoxville TN 2013,2013,Metropolitan Statistical Area,,,851951,4134,9462,8692,770,780,2324,3104,260
Kokomo IN 2013,2013,Metropolitan Statistical Area,,,82961,-12,1032,906,126,79,-201,-122,-16
La Crosse-Onalaska WI-MN 2013,2013,Metropolitan Statistical Area,,,136156,509,1432,1125,307,156,12,168,34
Lafayette LA 2013,2013,Metropolitan Statistical Area,,,479763,5543,6808,4149,2659,788,2033,2821,63
Lafayette-West Lafayette IN 2013,2013,Metropolitan Statistical Area,,,209769,2659,2683,1343,1340,1403,-58,1345,-26
Lake Charles LA 2013,2013,Metropolitan Statistical Area,,,202461,1185,2842,1943,899,234,114,348,-62
Lake Havasu City-Kingman AZ 2013,2013,Metropolitan Statistical Area,,,202855,-319,1750,2638,-888,9,293,302,267
Lakeland-Winter Haven FL 2013,2013,Metropolitan Statistical Area,,,623159,7395,7281,6187,1094,2660,3051,5711,590
Lancaster PA 2013,2013,Metropolitan Statistical Area,,,530122,3356,6996,4806,2190,1210,-405,805,361
Lansing-East Lansing MI 2013,2013,Metropolitan Statistical Area,,,468348,1682,5243,3567,1676,2116,-2156,-40,46
Laredo TX 2013,2013,Metropolitan Statistical Area,,,263772,3786,5471,1244,4227,678,-1197,-519,78
Las Cruces NM 2013,2013,Metropolitan Statistical Area,,,213697,-511,2947,1438,1509,139,-2264,-2125,105
Las Vegas-Henderson-Paradise NV 2013,2013,Metropolitan Statistical Area,,,2029316,30670,26181,14598,11583,7344,10886,18230,857
Lawrence KS 2013,2013,Metropolitan Statistical Area,,,114803,1464,1239,651,588,621,235,856,20
Lawton OK 2013,2013,Metropolitan Statistical Area,,,131188,-1570,1993,1050,943,513,-3049,-2536,23
Lebanon PA 2013,2013,Metropolitan Statistical Area,,,135707,125,1663,1361,302,395,-620,-225,48
Lewiston ID-WA 2013,2013,Metropolitan Statistical Area,,,62042,592,736,748,-12,35,567,602,2
Lewiston-Auburn ME 2013,2013,Metropolitan Statistical Area,,,107391,-115,1317,1039,278,118,-594,-476,83
Lexington-Fayette KY 2013,2013,Metropolitan Statistical Area,,,489324,4708,6215,3653,2562,1282,825,2107,39
Lima OH 2013,2013,Metropolitan Statistical Area,,,105214,-69,1304,1094,210,58,-347,-289,10
Lincoln NE 2013,2013,Metropolitan Statistical Area,,,314349,3915,4231,2000,2231,904,693,1597,87
Little Rock-North Little Rock-Conway AR 2013,2013,Metropolitan Statistical Area,,,724335,6632,9882,6354,3528,977,2343,3320,-216
Logan UT-ID 2013,2013,Metropolitan Statistical Area,,,130175,1406,2600,576,2024,329,-992,-663,45
Longview TX 2013,2013,Metropolitan Statistical Area,,,216957,-1634,3010,2219,791,274,-2717,-2443,18
Longview WA 2013,2013,Metropolitan Statistical Area,,,101729,-48,1139,1084,55,23,-167,-144,41
Los Angeles-Long Beach-Anaheim CA 2013,2013,Metropolitan Statistical Area,,,13175849,111088,170665,80079,90586,65385,-44458,20927,-425
Anaheim-Santa Ana-Irvine CA 2013,2013,Metropolitan Division,,,3121854,31961,38340,18850,19490,13241,-1478,11763,708
Los Angeles-Long Beach-Glendale CA 2013,2013,Metropolitan Division,,,10053995,79127,132325,61229,71096,52144,-42980,9164,-1133
Louisville/Jefferson County KY-IN 2013,2013,Metropolitan Statistical Area,,,1262244,10374,15611,11577,4034,2333,4111,6444,-104
Lubbock TX 2013,2013,Metropolitan Statistical Area,,,301760,3788,4212,2386,1826,452,1428,1880,82
Lynchburg VA 2013,2013,Metropolitan Statistical Area,,,256724,1190,2749,2488,261,380,576,956,-27
Macon GA 2013,2013,Metropolitan Statistical Area,,,231332,-1508,2958,2450,508,198,-2243,-2045,29
Madera CA 2013,2013,Metropolitan Statistical Area,,,152165,-79,2182,932,1250,191,-1408,-1217,-112
Madison WI 2013,2013,Metropolitan Statistical Area,,,627466,7065,7430,3985,3445,1670,1602,3272,348
Manchester-Nashua NH 2013,2013,Metropolitan Statistical Area,,,403398,798,4285,2927,1358,1003,-1622,-619,59
Manhattan KS 2013,2013,Metropolitan Statistical Area,,,98575,-73,1546,480,1066,852,-2026,-1174,35
Mankato-North Mankato MN 2013,2013,Metropolitan Statistical Area,,,97718,-218,1091,682,409,107,-774,-667,40
Mansfield OH 2013,2013,Metropolitan Statistical Area,,,122292,-296,1408,1293,115,23,-438,-415,4
McAllen-Edinburg-Mission TX 2013,2013,Metropolitan Statistical Area,,,818942,11217,16158,3949,12209,1815,-3234,-1419,427
Medford OR 2013,2013,Metropolitan Statistical Area,,,208091,1728,2302,2179,123,73,1428,1501,104
Memphis TN-MS-AR 2013,2013,Metropolitan Statistical Area,,,1341710,955,18906,11350,7556,1802,-8336,-6534,-67
Merced CA 2013,2013,Metropolitan Statistical Area,,,263481,1698,4271,1628,2643,542,-1491,-949,4
Miami-Fort Lauderdale-West Palm Beach FL 2013,2013,Metropolitan Statistical Area,,,5863458,74112,65939,47762,18177,62330,-9771,52559,3376
Fort Lauderdale-Pompano Beach-Deerfield Beach FL 2013,2013,Metropolitan Division,,,1845393,25620,21307,14665,6642,15505,2866,18371,607
Miami-Miami Beach-Kendall FL 2013,2013,Metropolitan Division,,,2641866,30906,30634,19213,11421,38795,-21010,17785,1700
West Palm Beach-Boca Raton-Delray Beach FL 2013,2013,Metropolitan Division,,,1376199,17586,13998,13884,114,8030,8373,16403,1069
Michigan City-La Porte IN 2013,2013,Metropolitan Statistical Area,,,111256,98,1294,1135,159,14,-60,-46,-15
Midland MI 2013,2013,Metropolitan Statistical Area,,,83593,-56,838,719,119,143,-325,-182,7
Midland TX 2013,2013,Metropolitan Statistical Area,,,157240,5148,2740,1082,1658,109,3456,3565,-75
Milwaukee-Waukesha-West Allis WI 2013,2013,Metropolitan Statistical Area,,,1570167,3412,19848,12914,6934,2478,-5734,-3256,-266
Minneapolis-St. Paul-Bloomington MN-WI 2013,2013,Metropolitan Statistical Area,,,3461434,38364,45955,21753,24202,11506,2391,13897,265
Missoula MT 2013,2013,Metropolitan Statistical Area,,,111769,715,1237,789,448,119,119,238,29
Mobile AL 2013,2013,Metropolitan Statistical Area,,,414560,605,5479,4352,1127,696,-1351,-655,133
Modesto CA 2013,2013,Metropolitan Statistical Area,,,526286,4152,7519,3767,3752,1339,-1161,178,222
Monroe LA 2013,2013,Metropolitan Statistical Area,,,178618,733,2468,1752,716,170,-190,-20,37
Monroe MI 2013,2013,Metropolitan Statistical Area,,,150179,-661,1468,1456,12,72,-829,-757,84
Montgomery AL 2013,2013,Metropolitan Statistical Area,,,373945,-1929,4826,3540,1286,533,-3874,-3341,126
Morgantown WV 2013,2013,Metropolitan Statistical Area,,,135925,1484,1326,973,353,347,769,1116,15
Morristown TN 2013,2013,Metropolitan Statistical Area,,,115374,332,1344,1282,62,81,118,199,71
Mount Vernon-Anacortes WA 2013,2013,Metropolitan Statistical Area,,,118742,737,1431,1090,341,122,235,357,39
Muncie IN 2013,2013,Metropolitan Statistical Area,,,117355,46,1255,1156,99,132,-174,-42,-11
Muskegon MI 2013,2013,Metropolitan Statistical Area,,,172246,2100,2095,1647,448,85,1510,1595,57
Myrtle Beach-Conway-North Myrtle Beach SC-NC 2013,2013,Metropolitan Statistical Area,,,404789,10661,4080,4130,-50,448,10651,11099,-388
Napa CA 2013,2013,Metropolitan Statistical Area,,,140580,1445,1436,1260,176,469,735,1204,65
Naples-Immokalee-Marco Island FL 2013,2013,Metropolitan Statistical Area,,,340106,7233,3125,2956,169,2171,5131,7302,-238
Nashville-Davidson--Murfreesboro--Franklin TN 2013,2013,Metropolitan Statistical Area,,,1758577,31424,22806,13454,9352,4009,18029,22038,34
New Bern NC 2013,2013,Metropolitan Statistical Area,,,127589,-1041,1717,1200,517,485,-2151,-1666,108
New Haven-Milford CT 2013,2013,Metropolitan Statistical Area,,,863016,-1015,9050,7627,1423,3727,-5728,-2001,-437
New Orleans-Metairie LA 2013,2013,Metropolitan Statistical Area,,,1241949,13574,15456,11004,4452,3271,5755,9026,96
New York-Newark-Jersey City NY-NJ-PA 2013,2013,Metropolitan Statistical Area,,,20002086,127480,251588,144431,107157,146734,-113078,33656,-13333
Dutchess County-Putnam County NY 2013,2013,Metropolitan Division,,,396706,-291,3565,3116,449,1118,-2001,-883,143
Nassau County-Suffolk County NY 2013,2013,Metropolitan Division,,,2858052,6707,29438,23023,6415,9262,-8013,1249,-957
Newark NJ-PA 2013,2013,Metropolitan Division,,,2501610,11523,28542,18363,10179,14423,-11643,2780,-1436
New York-Jersey City-White Plains NY-NJ 2013,2013,Metropolitan Division,,,14245718,109541,190043,99929,90114,121931,-91421,30510,-11083
Niles-Benton Harbor MI 2013,2013,Metropolitan Statistical Area,,,155321,-736,1708,1646,62,334,-1200,-866,68
North Port-Sarasota-Bradenton FL 2013,2013,Metropolitan Statistical Area,,,732659,12538,6219,8604,-2385,1932,12892,14824,99
Norwich-New London CT 2013,2013,Metropolitan Statistical Area,,,273976,-568,2702,2285,417,1288,-2181,-893,-92
Ocala FL 2013,2013,Metropolitan Statistical Area,,,336159,1664,3245,4750,-1505,615,2216,2831,338
Ocean City NJ 2013,2013,Metropolitan Statistical Area,,,95849,-549,904,1260,-356,191,-351,-160,-33
Odessa TX 2013,2013,Metropolitan Statistical Area,,,149522,5078,2894,1155,1739,45,3360,3405,-66
Ogden-Clearfield UT 2013,2013,Metropolitan Statistical Area,,,622238,9609,10799,3511,7288,739,1371,2110,211
Oklahoma City OK 2013,2013,Metropolitan Statistical Area,,,1320585,22699,18877,10763,8114,2736,11315,14051,534
Olympia-Tumwater WA 2013,2013,Metropolitan Statistical Area,,,262561,3848,3135,2031,1104,667,2053,2720,24
Omaha-Council Bluffs NE-IA 2013,2013,Metropolitan Statistical Area,,,895573,9866,13186,6446,6740,1952,1325,3277,-151
Orlando-Kissimmee-Sanford FL 2013,2013,Metropolitan Statistical Area,,,2271083,45182,27196,16204,10992,15025,18538,33563,627
Oshkosh-Neenah WI 2013,2013,Metropolitan Statistical Area,,,169360,726,1876,1387,489,83,133,216,21
Owensboro KY 2013,2013,Metropolitan Statistical Area,,,116399,481,1548,1183,365,44,18,62,54
Oxnard-Thousand Oaks-Ventura CA 2013,2013,Metropolitan Statistical Area,,,840972,5496,10590,5440,5150,1794,-1905,-111,457
Palm Bay-Melbourne-Titusville FL 2013,2013,Metropolitan Statistical Area,,,551440,3771,5013,6636,-1623,1175,3830,5005,389
Panama City FL 2013,2013,Metropolitan Statistical Area,,,190771,3107,2376,1958,418,333,2240,2573,116
Parkersburg-Vienna WV 2013,2013,Metropolitan Statistical Area,,,92275,-92,982,1063,-81,15,-17,-2,-9
Pensacola-Ferry Pass-Brent FL 2013,2013,Metropolitan Statistical Area,,,468682,6070,5669,4484,1185,1215,3406,4621,264
Peoria IL 2013,2013,Metropolitan Statistical Area,,,382079,1629,5012,3685,1327,416,37,453,-151
Philadelphia-Camden-Wilmington PA-NJ-DE-MD 2013,2013,Metropolitan Statistical Area,,,6036228,15303,72068,53462,18606,19543,-22380,-2837,-466
Camden NJ 2013,2013,Metropolitan Division,,,1252206,-1776,13578,10838,2740,2998,-7565,-4567,51
Montgomery County-Bucks County-Chester County PA 2013,2013,Metropolitan Division,,,1949788,7664,20289,16716,3573,4479,-953,3526,565
Philadelphia PA 2013,2013,Metropolitan Division,,,2117896,6584,29822,20008,9814,10258,-12220,-1962,-1268
Wilmington DE-MD-NJ 2013,2013,Metropolitan Division,,,716338,2831,8379,5900,2479,1808,-1642,166,186
Phoenix-Mesa-Scottsdale AZ 2013,2013,Metropolitan Statistical Area,,,4404129,73155,59828,29848,29980,10559,31187,41746,1429
Pine Bluff AR 2013,2013,Metropolitan Statistical Area,,,95689,-1655,1184,1087,97,8,-1647,-1639,-113
Pittsburgh PA 2013,2013,Metropolitan Statistical Area,,,2360565,-503,23886,27097,-3211,3220,-23,3197,-489
Pittsfield MA 2013,2013,Metropolitan Statistical Area,,,129489,-741,1080,1468,-388,200,-538,-338,-15
Pocatello ID 2013,2013,Metropolitan Statistical Area,,,83322,-419,1302,658,644,86,-1182,-1096,33
Portland-South Portland ME 2013,2013,Metropolitan Statistical Area,,,520363,2144,4937,4583,354,810,657,1467,323
Portland-Vancouver-Hillsboro OR-WA 2013,2013,Metropolitan Statistical Area,,,2314747,26018,27647,16118,11529,5543,8260,13803,686
Port St. Lucie FL 2013,2013,Metropolitan Statistical Area,,,437785,5380,4052,4723,-671,985,4945,5930,121
Prescott AZ 2013,2013,Metropolitan Statistical Area,,,215389,2880,1885,2680,-795,156,3540,3696,-21
Providence-Warwick RI-MA 2013,2013,Metropolitan Statistical Area,,,1605521,2119,16493,14437,2056,5215,-5264,-49,112
Provo-Orem UT 2013,2013,Metropolitan Statistical Area,,,562253,12323,12358,2136,10222,859,1200,2059,42
Pueblo CO 2013,2013,Metropolitan Statistical Area,,,161320,480,1907,1614,293,68,52,120,67
Punta Gorda FL 2013,2013,Metropolitan Statistical Area,,,164948,2156,1037,2388,-1351,274,3242,3516,-9
Racine WI 2013,2013,Metropolitan Statistical Area,,,194922,239,2350,1648,702,154,-588,-434,-29
Raleigh NC 2013,2013,Metropolitan Statistical Area,,,1215299,26224,15378,6653,8725,4165,12914,17079,420
Rapid City SD 2013,2013,Metropolitan Statistical Area,,,141363,2572,1952,1033,919,152,1469,1621,32
Reading PA 2013,2013,Metropolitan Statistical Area,,,413652,400,4834,3668,1166,1193,-1917,-724,-42
Redding CA 2013,2013,Metropolitan Statistical Area,,,179137,716,2090,2034,56,224,287,511,149
Reno NV 2013,2013,Metropolitan Statistical Area,,,437713,4712,5401,3516,1885,783,2014,2797,30
Richmond VA 2013,2013,Metropolitan Statistical Area,,,1246867,13145,14878,10099,4779,3666,4642,8308,58
Riverside-San Bernardino-Ontario CA 2013,2013,Metropolitan Statistical Area,,,4390262,41592,61362,28660,32702,8664,-1014,7650,1240
Roanoke VA 2013,2013,Metropolitan Statistical Area,,,312404,1694,3443,3343,100,715,792,1507,87
Rochester MN 2013,2013,Metropolitan Statistical Area,,,211838,2129,2823,1436,1387,665,22,687,55
Rochester NY 2013,2013,Metropolitan Statistical Area,,,1084094,1035,11561,9430,2131,3067,-4338,-1271,175
Rockford IL 2013,2013,Metropolitan Statistical Area,,,344755,-1048,4096,3046,1050,362,-2512,-2150,52
Rocky Mount NC 2013,2013,Metropolitan Statistical Area,,,150114,-920,1772,1537,235,61,-1297,-1236,81
Rome GA 2013,2013,Metropolitan Statistical Area,,,96025,-41,1165,1058,107,116,-335,-219,71
Sacramento--Roseville--Arden-Arcade CA 2013,2013,Metropolitan Statistical Area,,,2217515,22428,27398,16194,11204,7396,3073,10469,755
Saginaw MI 2013,2013,Metropolitan Statistical Area,,,196660,-1608,2279,2035,244,168,-2039,-1871,19
St. Cloud MN 2013,2013,Metropolitan Statistical Area,,,191348,835,2422,1206,1216,244,-611,-367,-14
St. George UT 2013,2013,Metropolitan Statistical Area,,,147719,3076,2155,1107,1048,65,2098,2163,-135
St. Joseph MO-KS 2013,2013,Metropolitan Statistical Area,,,127779,-171,1531,1298,233,174,-551,-377,-27
St. Louis MO-IL 2013,2013,Metropolitan Statistical Area,,,2801587,4306,33785,24964,8821,4495,-8926,-4431,-84
Salem OR 2013,2013,Metropolitan Statistical Area,,,398846,2507,5135,3262,1873,452,168,620,14
Salinas CA 2013,2013,Metropolitan Statistical Area,,,429123,2712,6529,2387,4142,1125,-2515,-1390,-40
Salisbury MD-DE 2013,2013,Metropolitan Statistical Area,,,385140,3733,4197,4058,139,953,2734,3687,-93
Salt Lake City UT 2013,2013,Metropolitan Statistical Area,,,1141584,17362,19190,6218,12972,3175,1150,4325,65
San Angelo TX 2013,2013,Metropolitan Statistical Area,,,116564,1467,1535,1003,532,203,732,935,0
San Antonio-New Braunfels TX 2013,2013,Metropolitan Statistical Area,,,2282201,44430,31763,16147,15616,5045,22523,27568,1246
San Diego-Carlsbad CA 2013,2013,Metropolitan Statistical Area,,,3222558,39145,44330,20791,23539,15456,-1027,14429,1177
San Francisco-Oakland-Hayward CA 2013,2013,Metropolitan Statistical Area,,,4529654,67475,52707,29878,22829,28482,16400,44882,-236
Oakland-Hayward-Berkeley CA 2013,2013,Metropolitan Division,,,2679206,43599,31976,17293,14683,15332,12893,28225,691
San Francisco-Redwood City-South San Francisco CA 2013,2013,Metropolitan Division,,,1591627,21198,18438,10740,7698,12228,2192,14420,-920
San Rafael CA 2013,2013,Metropolitan Division,,,258821,2678,2293,1845,448,922,1315,2237,-7
San Jose-Sunnyvale-Santa Clara CA 2013,2013,Metropolitan Statistical Area,,,1928701,30732,25300,10151,15149,17368,-1526,15842,-259
San Luis Obispo-Paso Robles-Arroyo Grande CA 2013,2013,Metropolitan Statistical Area,,,276284,1756,2580,2204,376,239,966,1205,175
Santa Cruz-Watsonville CA 2013,2013,Metropolitan Statistical Area,,,269444,2812,3063,1744,1319,410,943,1353,140
Santa Fe NM 2013,2013,Metropolitan Statistical Area,,,147306,921,1332,1080,252,411,130,541,128
Santa Maria-Santa Barbara CA 2013,2013,Metropolitan Statistical Area,,,436076,5348,5650,2979,2671,1386,1101,2487,190
Santa Rosa CA 2013,2013,Metropolitan Statistical Area,,,495432,4594,5198,4010,1188,678,2568,3246,160
Savannah GA 2013,2013,Metropolitan Statistical Area,,,366049,3756,5251,2891,2360,924,261,1185,211
Scranton--Wilkes-Barre--Hazleton PA 2013,2013,Metropolitan Statistical Area,,,561838,-2296,5474,6914,-1440,1137,-1897,-760,-96
Seattle-Tacoma-Bellevue WA 2013,2013,Metropolitan Statistical Area,,,3613621,59790,46171,23578,22593,19053,17436,36489,708
Seattle-Bellevue-Everett WA 2013,2013,Metropolitan Division,,,2793402,51934,34965,17508,17457,16654,17511,34165,312
Tacoma-Lakewood WA 2013,2013,Metropolitan Division,,,820219,7856,11206,6070,5136,2399,-75,2324,396
Sebastian-Vero Beach FL 2013,2013,Metropolitan Statistical Area,,,142021,1413,1221,1851,-630,253,1839,2092,-49
Sebring FL 2013,2013,Metropolitan Statistical Area,,,97919,-168,894,1474,-580,216,111,327,85
Sheboygan WI 2013,2013,Metropolitan Statistical Area,,,114868,-84,1279,1104,175,96,-380,-284,25
Sherman-Denison TX 2013,2013,Metropolitan Statistical Area,,,122343,712,1513,1321,192,140,298,438,82
Shreveport-Bossier City LA 2013,2013,Metropolitan Statistical Area,,,446825,-1554,6503,4538,1965,491,-3888,-3397,-122
Sierra Vista-Douglas AZ 2013,2013,Metropolitan Statistical Area,,,129744,-2175,1654,1253,401,324,-2953,-2629,53
Sioux City IA-NE-SD 2013,2013,Metropolitan Statistical Area,,,168785,-11,2403,1388,1015,288,-1248,-960,-66
Sioux Falls SD 2013,2013,Metropolitan Statistical Area,,,243622,5874,3793,1574,2219,754,2789,3543,112
South Bend-Mishawaka IN-MI 2013,2013,Metropolitan Statistical Area,,,318532,-93,3846,2844,1002,531,-1410,-879,-216
Spartanburg SC 2013,2013,Metropolitan Statistical Area,,,318800,2157,3804,3278,526,207,1322,1529,102
Spokane-Spokane Valley WA 2013,2013,Metropolitan Statistical Area,,,535684,3372,6685,4821,1864,810,642,1452,56
Springfield IL 2013,2013,Metropolitan Statistical Area,,,211645,-311,2458,2095,363,180,-958,-778,104
Springfield MA 2013,2013,Metropolitan Statistical Area,,,628384,1494,6492,5593,899,3423,-2510,913,-318
Springfield MO 2013,2013,Metropolitan Statistical Area,,,448852,4171,5655,3913,1742,338,2024,2362,67
Springfield OH 2013,2013,Metropolitan Statistical Area,,,136803,-391,1588,1674,-86,64,-389,-325,20
State College PA 2013,2013,Metropolitan Statistical Area,,,157847,2265,1308,967,341,881,970,1851,73
Staunton-Waynesboro VA 2013,2013,Metropolitan Statistical Area,,,119403,774,1226,1287,-61,52,712,764,71
Stockton-Lodi CA 2013,2013,Metropolitan Statistical Area,,,705027,3392,10166,5019,5147,1719,-3923,-2204,449
Sumter SC 2013,2013,Metropolitan Statistical Area,,,108002,-58,1515,1001,514,153,-765,-612,40
Syracuse NY 2013,2013,Metropolitan Statistical Area,,,662861,1605,7392,5715,1677,1777,-1909,-132,60
Tallahassee FL 2013,2013,Metropolitan Statistical Area,,,373583,-1940,4031,2726,1305,835,-4273,-3438,193
Tampa-St. Petersburg-Clearwater FL 2013,2013,Metropolitan Statistical Area,,,2874154,26151,31130,30042,1088,11045,11934,22979,2084
Terre Haute IN 2013,2013,Metropolitan Statistical Area,,,172201,-425,1961,1769,192,202,-863,-661,44
Texarkana TX-AR 2013,2013,Metropolitan Statistical Area,,,149563,-47,1957,1618,339,45,-396,-351,-35
The Villages FL 2013,2013,Metropolitan Statistical Area,,,108483,5660,472,1344,-872,72,7929,8001,-1469
Toledo OH 2013,2013,Metropolitan Statistical Area,,,608430,-121,7578,5795,1783,728,-2644,-1916,12
Topeka KS 2013,2013,Metropolitan Statistical Area,,,233894,-550,3071,2291,780,165,-1498,-1333,3
Trenton NJ 2013,2013,Metropolitan Statistical Area,,,371052,1995,4380,2732,1648,2555,-2067,488,-141
Tucson AZ 2013,2013,Metropolitan Statistical Area,,,998050,4956,12169,8992,3177,2266,-908,1358,421
Tulsa OK 2013,2013,Metropolitan Statistical Area,,,962424,9588,13110,9025,4085,1159,4029,5188,315
Tuscaloosa AL 2013,2013,Metropolitan Statistical Area,,,235438,2061,2804,2059,745,263,988,1251,65
Tyler TX 2013,2013,Metropolitan Statistical Area,,,216670,1729,3036,1957,1079,250,281,531,119
Urban Honolulu HI 2013,2013,Metropolitan Statistical Area,,,987019,10273,13662,7713,5949,7108,-2792,4316,8
Utica-Rome NY 2013,2013,Metropolitan Statistical Area,,,298047,-506,3267,3136,131,780,-1305,-525,-112
Valdosta GA 2013,2013,Metropolitan Statistical Area,,,142828,-1786,2057,1129,928,233,-3054,-2821,107
Vallejo-Fairfield CA 2013,2013,Metropolitan Statistical Area,,,425219,4495,5108,3098,2010,1574,730,2304,181
Victoria TX 2013,2013,Metropolitan Statistical Area,,,97592,978,1363,822,541,87,354,441,-4
Vineland-Bridgeton NJ 2013,2013,Metropolitan Statistical Area,,,157153,-641,2075,1435,640,492,-1717,-1225,-56
Virginia Beach-Norfolk-Newport News VA-NC 2013,2013,Metropolitan Statistical Area,,,1707385,8994,22649,13332,9317,5527,-5969,-442,119
Visalia-Porterville CA 2013,2013,Metropolitan Statistical Area,,,454725,3226,7908,2802,5106,387,-2112,-1725,-155
Waco TX 2013,2013,Metropolitan Statistical Area,,,259099,1988,3655,2240,1415,286,240,526,47
Walla Walla WA 2013,2013,Metropolitan Statistical Area,,,63673,214,721,593,128,77,-15,62,24
Warner Robins GA 2013,2013,Metropolitan Statistical Area,,,186355,965,2424,1352,1072,348,-500,-152,45
Washington-Arlington-Alexandria DC-VA-MD-WV 2013,2013,Metropolitan Statistical Area,,,5967176,93696,81130,33226,47904,43253,4375,47628,-1836
Silver Spring-Frederick-Rockville MD 2013,2013,Metropolitan Division,,,1261181,14966,15941,7708,8233,10979,-4523,6456,277
Washington-Arlington-Alexandria DC-VA-MD-WV 2013,2013,Metropolitan Division,,,4705995,78730,65189,25518,39671,32274,8898,41172,-2113
Waterloo-Cedar Falls IA 2013,2013,Metropolitan Statistical Area,,,169479,932,2096,1507,589,194,100,294,49
Watertown-Fort Drum NY 2013,2013,Metropolitan Statistical Area,,,119536,-1380,2252,885,1367,691,-3522,-2831,84
Wausau WI 2013,2013,Metropolitan Statistical Area,,,135365,676,1584,1091,493,118,-17,101,82
Weirton-Steubenville WV-OH 2013,2013,Metropolitan Statistical Area,,,121942,-524,1156,1643,-487,6,-25,-19,-18
Wenatchee WA 2013,2013,Metropolitan Statistical Area,,,113496,501,1425,953,472,93,-73,20,9
Wheeling WV-OH 2013,2013,Metropolitan Statistical Area,,,145853,-511,1577,1866,-289,41,-148,-107,-115
Wichita KS 2013,2013,Metropolitan Statistical Area,,,638259,2317,9531,5429,4102,986,-2975,-1989,204
Wichita Falls TX 2013,2013,Metropolitan Statistical Area,,,151529,543,1948,1508,440,417,-289,128,-25
Williamsport PA 2013,2013,Metropolitan Statistical Area,,,116732,-564,1322,1268,54,77,-695,-618,0
Wilmington NC 2013,2013,Metropolitan Statistical Area,,,268301,5200,2829,2239,590,309,4152,4461,149
Winchester VA-WV 2013,2013,Metropolitan Statistical Area,,,132221,1204,1544,1110,434,127,735,862,-92
Winston-Salem NC 2013,2013,Metropolitan Statistical Area,,,651520,3833,7468,6172,1296,912,1164,2076,461
Worcester MA-CT 2013,2013,Metropolitan Statistical Area,,,928050,3978,9872,7633,2239,3728,-2102,1626,113
Yakima WA 2013,2013,Metropolitan Statistical Area,,,247297,576,4065,1922,2143,113,-1718,-1605,38
York-Hanover PA 2013,2013,Metropolitan Statistical Area,,,439393,1694,4909,3739,1170,590,-157,433,91
Youngstown-Warren-Boardman OH-PA 2013,2013,Metropolitan Statistical Area,,,556129,-2844,5653,6861,-1208,268,-1752,-1484,-152
Yuba City CA 2013,2013,Metropolitan Statistical Area,,,168648,1034,2475,1243,1232,680,-875,-195,-3
Yuma AZ 2013,2013,Metropolitan Statistical Area,,,202033,-231,3109,1341,1768,508,-2730,-2222,223
Abilene TX 2014,2014,Metropolitan Statistical Area,,,168592,1140,2351,1655,696,291,138,429,15
Akron OH 2014,2014,Metropolitan Statistical Area,,,703825,615,7604,6924,680,1126,-742,384,-449
Albany GA 2014,2014,Metropolitan Statistical Area,,,154925,-865,2093,1421,672,95,-1617,-1522,-15
Albany OR 2014,2014,Metropolitan Statistical Area,,,119356,712,1412,1186,226,44,425,469,17
Albany-Schenectady-Troy NY 2014,2014,Metropolitan Statistical Area,,,880167,1688,9186,7735,1451,2447,-1968,479,-242
Albuquerque NM 2014,2014,Metropolitan Statistical Area,,,904587,1242,10774,7214,3560,1159,-3423,-2264,-54
Alexandria LA 2014,2014,Metropolitan Statistical Area,,,154872,-31,2014,1557,457,165,-627,-462,-26
Allentown-Bethlehem-Easton PA-NJ 2014,2014,Metropolitan Statistical Area,,,829835,2791,8630,7679,951,2429,-309,2120,-280
Altoona PA 2014,2014,Metropolitan Statistical Area,,,125955,-424,1327,1627,-300,37,-186,-149,25
Amarillo TX 2014,2014,Metropolitan Statistical Area,,,259885,1052,3793,2212,1581,682,-1177,-495,-34
Ames IA 2014,2014,Metropolitan Statistical Area,,,94073,663,938,492,446,693,-446,247,-30
Anchorage AK 2014,2014,Metropolitan Statistical Area,,,398892,1371,6040,2207,3833,1238,-3879,-2641,179
Ann Arbor MI 2014,2014,Metropolitan Statistical Area,,,356874,2456,3690,2139,1551,2119,-1090,1029,-124
Anniston-Oxford-Jacksonville AL 2014,2014,Metropolitan Statistical Area,,,115916,-631,1292,1401,-109,31,-471,-440,-82
Appleton WI 2014,2014,Metropolitan Statistical Area,,,231497,1628,2808,1551,1257,196,228,424,-53
Asheville NC 2014,2014,Metropolitan Statistical Area,,,442316,4655,4486,4721,-235,413,4113,4526,364
Athens-Clarke County GA 2014,2014,Metropolitan Statistical Area,,,199016,1132,2242,1291,951,487,-387,100,81
Atlanta-Sandy Springs-Roswell GA 2014,2014,Metropolitan Statistical Area,,,5614323,88891,71724,35043,36681,18816,32294,51110,1100
Atlantic City-Hammonton NJ 2014,2014,Metropolitan Statistical Area,,,275209,-958,3315,2637,678,1506,-3052,-1546,-90
Auburn-Opelika AL 2014,2014,Metropolitan Statistical Area,,,154255,2547,1837,1006,831,611,1034,1645,71
Augusta-Richmond County GA-SC 2014,2014,Metropolitan Statistical Area,,,583632,3402,7390,5169,2221,918,259,1177,4
Austin-Round Rock TX 2014,2014,Metropolitan Statistical Area,,,1943299,57496,25782,9207,16575,6474,33059,39533,1388
Bakersfield CA 2014,2014,Metropolitan Statistical Area,,,874589,8666,14763,5763,9000,1842,-1775,67,-401
Baltimore-Columbia-Towson MD 2014,2014,Metropolitan Statistical Area,,,2785874,11824,33812,24520,9292,9639,-6448,3191,-659
Bangor ME 2014,2014,Metropolitan Statistical Area,,,153414,-65,1455,1497,-42,154,-150,4,-27
Barnstable Town MA 2014,2014,Metropolitan Statistical Area,,,214914,78,1572,2817,-1245,338,975,1313,10
Baton Rouge LA 2014,2014,Metropolitan Statistical Area,,,825478,5069,11012,6662,4350,1312,-397,915,-196
Battle Creek MI 2014,2014,Metropolitan Statistical Area,,,134878,48,1683,1373,310,201,-399,-198,-64
Bay City MI 2014,2014,Metropolitan Statistical Area,,,106179,-757,1043,1140,-97,43,-634,-591,-69
Beaumont-Port Arthur TX 2014,2014,Metropolitan Statistical Area,,,405427,3,5381,4067,1314,598,-1808,-1210,-101
Beckley WV 2014,2014,Metropolitan Statistical Area,,,123373,-823,1479,1711,-232,92,-658,-566,-25
Bellingham WA 2014,2014,Metropolitan Statistical Area,,,208351,2103,2257,1518,739,343,1021,1364,0
Bend-Redmond OR 2014,2014,Metropolitan Statistical Area,,,170388,4433,1707,1304,403,-4,3686,3682,348
Billings MT 2014,2014,Metropolitan Statistical Area,,,166885,1663,2130,1459,671,49,998,1047,-55
Binghamton NY 2014,2014,Metropolitan Statistical Area,,,247219,-1143,2576,2514,62,492,-1591,-1099,-106
Birmingham-Hoover AL 2014,2014,Metropolitan Statistical Area,,,1143772,4216,14471,11422,3049,1254,230,1484,-317
Bismarck ND 2014,2014,Metropolitan Statistical Area,,,126597,2604,1836,988,848,23,1690,1713,43
Blacksburg-Christiansburg-Radford VA 2014,2014,Metropolitan Statistical Area,,,181605,653,1754,1435,319,762,-345,417,-83
Bloomington IL 2014,2014,Metropolitan Statistical Area,,,190345,-949,2356,1334,1022,590,-2601,-2011,40
Bloomington IN 2014,2014,Metropolitan Statistical Area,,,164308,1118,1500,1070,430,943,-232,711,-23
Bloomsburg-Berwick PA 2014,2014,Metropolitan Statistical Area,,,85763,89,858,894,-36,165,-15,150,-25
Boise City ID 2014,2014,Metropolitan Statistical Area,,,664422,13965,8721,4198,4523,925,7868,8793,649
Boston-Cambridge-Newton MA-NH 2014,2014,Metropolitan Statistical Area,,,4732161,34112,52482,35657,16825,29134,-10256,18878,-1591
Boston MA 2014,2014,Metropolitan Division,,,1966530,14092,22213,14974,7239,13291,-5872,7419,-566
Cambridge-Newton-Framingham MA 2014,2014,Metropolitan Division,,,2339406,17182,26453,17570,8883,15499,-6310,9189,-890
Rockingham County-Strafford County NH 2014,2014,Metropolitan Division,,,426225,2838,3816,3113,703,344,1926,2270,-135
Boulder CO 2014,2014,Metropolitan Statistical Area,,,313333,2937,3028,1725,1303,922,731,1653,-19
Bowling Green KY 2014,2014,Metropolitan Statistical Area,,,165732,1891,2004,1367,637,508,792,1300,-46
Bremerton-Silverdale WA 2014,2014,Metropolitan Statistical Area,,,254183,978,2895,2094,801,374,-274,100,77
Bridgeport-Stamford-Norwalk CT 2014,2014,Metropolitan Statistical Area,,,945438,3319,10087,6579,3508,6135,-6506,-371,182
Brownsville-Harlingen TX 2014,2014,Metropolitan Statistical Area,,,420392,2175,7277,2505,4772,739,-3327,-2588,-9
Brunswick GA 2014,2014,Metropolitan Statistical Area,,,114806,794,1321,1102,219,113,404,517,58
Buffalo-Cheektowaga-Niagara Falls NY 2014,2014,Metropolitan Statistical Area,,,1136360,207,12215,11907,308,3210,-2445,765,-866
Burlington NC 2014,2014,Metropolitan Statistical Area,,,155792,1107,1759,1524,235,151,684,835,37
Burlington-South Burlington VT 2014,2014,Metropolitan Statistical Area,,,216167,1095,2236,1406,830,463,-137,326,-61
California-Lexington Park MD 2014,2014,Metropolitan Statistical Area,,,110382,898,1389,774,615,186,71,257,26
Canton-Massillon OH 2014,2014,Metropolitan Statistical Area,,,403923,430,4370,4191,179,236,219,455,-204
Cape Coral-Fort Myers FL 2014,2014,Metropolitan Statistical Area,,,679513,18177,6516,6568,-52,2922,13517,16439,1790
Cape Girardeau MO-IL 2014,2014,Metropolitan Statistical Area,,,97929,312,1150,908,242,116,-36,80,-10
Carbondale-Marion IL 2014,2014,Metropolitan Statistical Area,,,126685,-384,1432,1178,254,326,-892,-566,-72
Carson City NV 2014,2014,Metropolitan Statistical Area,,,54522,461,580,625,-45,3,426,429,77
Casper WY 2014,2014,Metropolitan Statistical Area,,,81624,481,1183,713,470,43,19,62,-51
Cedar Rapids IA 2014,2014,Metropolitan Statistical Area,,,263885,1537,3154,2064,1090,335,205,540,-93
Chambersburg-Waynesboro PA 2014,2014,Metropolitan Statistical Area,,,152892,701,1824,1500,324,217,150,367,10
Champaign-Urbana IL 2014,2014,Metropolitan Statistical Area,,,237252,1237,2662,1610,1052,1913,-1687,226,-41
Charleston WV 2014,2014,Metropolitan Statistical Area,,,222878,-1805,2542,2851,-309,70,-1412,-1342,-154
Charleston-North Charleston SC 2014,2014,Metropolitan Statistical Area,,,727689,15608,9336,5290,4046,1019,10000,11019,543
Charlotte-Concord-Gastonia NC-SC 2014,2014,Metropolitan Statistical Area,,,2380314,42975,29696,17446,12250,5767,24097,29864,861
Charlottesville VA 2014,2014,Metropolitan Statistical Area,,,226968,2190,2450,1705,745,886,471,1357,88
Chattanooga TN-GA 2014,2014,Metropolitan Statistical Area,,,544559,2398,6299,5375,924,600,1046,1646,-172
Cheyenne WY 2014,2014,Metropolitan Statistical Area,,,96389,374,1266,762,504,102,-172,-70,-60
Chicago-Naperville-Elgin IL-IN-WI 2014,2014,Metropolitan Statistical Area,,,9554598,9802,119405,70059,49346,27410,-65815,-38405,-1139
Chicago-Naperville-Arlington Heights IL 2014,2014,Metropolitan Division,,,7343641,4735,93482,53967,39515,24185,-58428,-34243,-537
Elgin IL 2014,2014,Metropolitan Division,,,632768,3689,7878,3798,4080,922,-1364,-442,51
Gary IN 2014,2014,Metropolitan Division,,,704935,-355,8156,6688,1468,408,-1909,-1501,-322
Lake County-Kenosha County IL-WI 2014,2014,Metropolitan Division,,,873254,1733,9889,5606,4283,1895,-4114,-2219,-331
Chico CA 2014,2014,Metropolitan Statistical Area,,,224241,1821,2409,2287,122,274,1404,1678,21
Cincinnati OH-KY-IN 2014,2014,Metropolitan Statistical Area,,,2149449,10913,27504,18739,8765,3606,-947,2659,-511
Clarksville TN-KY 2014,2014,Metropolitan Statistical Area,,,278353,4900,5154,1922,3232,1060,550,1610,58
Cleveland TN 2014,2014,Metropolitan Statistical Area,,,119705,1168,1333,1157,176,120,837,957,35
Cleveland-Elyria OH 2014,2014,Metropolitan Statistical Area,,,2063598,-1730,23033,20585,2448,3957,-7798,-3841,-337
Coeur d'Alene ID 2014,2014,Metropolitan Statistical Area,,,147326,2969,1745,1242,503,47,2135,2182,284
College Station-Bryan TX 2014,2014,Metropolitan Statistical Area,,,242905,4660,3028,1308,1720,1518,1321,2839,101
Colorado Springs CO 2014,2014,Metropolitan Statistical Area,,,686908,8197,9476,4323,5153,1571,1511,3082,-38
Columbia MO 2014,2014,Metropolitan Statistical Area,,,172717,1788,2187,1030,1157,662,-6,656,-25
Columbia SC 2014,2014,Metropolitan Statistical Area,,,800495,8073,9445,6478,2967,1555,3469,5024,82
Columbus GA-AL 2014,2014,Metropolitan Statistical Area,,,314005,-3121,4783,2798,1985,717,-5859,-5142,36
Columbus IN 2014,2014,Metropolitan Statistical Area,,,80217,668,1089,674,415,259,40,299,-46
Columbus OH 2014,2014,Metropolitan Statistical Area,,,1994536,25504,27042,15131,11911,5358,8641,13999,-406
Corpus Christi TX 2014,2014,Metropolitan Statistical Area,,,448108,4660,6149,3673,2476,755,1480,2235,-51
Corvallis OR 2014,2014,Metropolitan Statistical Area,,,86316,356,729,526,203,382,-208,174,-21
Crestview-Fort Walton Beach-Destin FL 2014,2014,Metropolitan Statistical Area,,,258042,4733,3447,2208,1239,662,2578,3240,254
Cumberland MD-WV 2014,2014,Metropolitan Statistical Area,,,100530,-708,973,1250,-277,49,-449,-400,-31
Dallas-Fort Worth-Arlington TX 2014,2014,Metropolitan Statistical Area,,,6954330,131217,97026,41151,55875,24773,49403,74176,1166
Dallas-Plano-Irving TX 2014,2014,Metropolitan Division,,,4604097,92610,64252,25769,38483,18484,34578,53062,1065
Fort Worth-Arlington TX 2014,2014,Metropolitan Division,,,2350233,38607,32774,15382,17392,6289,14825,21114,101
Dalton GA 2014,2014,Metropolitan Statistical Area,,,142952,567,1855,1141,714,112,-235,-123,-24
Danville IL 2014,2014,Metropolitan Statistical Area,,,79728,-690,1080,919,161,24,-878,-854,3
Daphne-Fairhope-Foley AL 2014,2014,Metropolitan Statistical Area,,,200111,4668,2169,1947,222,283,3779,4062,384
Davenport-Moline-Rock Island IA-IL 2014,2014,Metropolitan Statistical Area,,,383030,-200,4764,3540,1224,534,-1771,-1237,-187
Dayton OH 2014,2014,Metropolitan Statistical Area,,,800836,-809,9571,7948,1623,1497,-3513,-2016,-416
Decatur AL 2014,2014,Metropolitan Statistical Area,,,153084,-115,1729,1581,148,119,-299,-180,-83
Decatur IL 2014,2014,Metropolitan Statistical Area,,,108350,-1085,1351,1138,213,85,-1378,-1293,-5
Deltona-Daytona Beach-Ormond Beach FL 2014,2014,Metropolitan Statistical Area,,,609939,8788,5480,7493,-2013,1183,8769,9952,849
Denver-Aurora-Lakewood CO 2014,2014,Metropolitan Statistical Area,,,2754258,54508,35245,16921,18324,6307,29386,35693,491
Des Moines-West Des Moines IA 2014,2014,Metropolitan Statistical Area,,,611549,11463,8814,4286,4528,1537,5325,6862,73
Detroit-Warren-Dearborn MI 2014,2014,Metropolitan Statistical Area,,,4296611,1217,49732,39427,10305,11196,-20048,-8852,-236
Detroit-Dearborn-Livonia MI 2014,2014,Metropolitan Division,,,1764804,-10899,22936,17419,5517,4067,-21314,-17247,831
Warren-Troy-Farmington Hills MI 2014,2014,Metropolitan Division,,,2531807,12116,26796,22008,4788,7129,1266,8395,-1067
Dothan AL 2014,2014,Metropolitan Statistical Area,,,148095,503,1727,1615,112,60,320,380,11
Dover DE 2014,2014,Metropolitan Statistical Area,,,171987,2425,2219,1542,677,392,1206,1598,150
Dubuque IA 2014,2014,Metropolitan Statistical Area,,,96370,458,1194,872,322,80,60,140,-4
Duluth MN-WI 2014,2014,Metropolitan Statistical Area,,,280218,276,2857,2777,80,220,147,367,-171
Durham-Chapel Hill NC 2014,2014,Metropolitan Statistical Area,,,542710,9088,6597,3686,2911,2234,3438,5672,505
East Stroudsburg PA 2014,2014,Metropolitan Statistical Area,,,166314,-816,1413,1443,-30,197,-942,-745,-41
Eau Claire WI 2014,2014,Metropolitan Statistical Area,,,165024,121,1933,1255,678,96,-599,-503,-54
El Centro CA 2014,2014,Metropolitan Statistical Area,,,179091,1574,3028,935,2093,288,-819,-531,12
Elizabethtown-Fort Knox KY 2014,2014,Metropolitan Statistical Area,,,151585,190,1943,1239,704,299,-800,-501,-13
Elkhart-Goshen IN 2014,2014,Metropolitan Statistical Area,,,201971,1380,3042,1542,1500,149,-171,-22,-98
Elmira NY 2014,2014,Metropolitan Statistical Area,,,87770,-715,1019,939,80,78,-820,-742,-53
El Paso TX 2014,2014,Metropolitan Statistical Area,,,836698,2068,13532,4932,8600,2149,-8490,-6341,-191
Erie PA 2014,2014,Metropolitan Statistical Area,,,278443,-1317,3108,2730,378,442,-1996,-1554,-141
Eugene OR 2014,2014,Metropolitan Statistical Area,,,358337,2676,3488,3304,184,697,1820,2517,-25
Evansville IN-KY 2014,2014,Metropolitan Statistical Area,,,315162,733,3829,3135,694,220,-103,117,-78
Fairbanks AK 2014,2014,Metropolitan Statistical Area,,,99357,-1450,1611,445,1166,298,-3017,-2719,103
Fargo ND-MN 2014,2014,Metropolitan Statistical Area,,,228291,4438,3311,1407,1904,703,1746,2449,85
Farmington NM 2014,2014,Metropolitan Statistical Area,,,123785,-2663,1781,985,796,27,-3497,-3470,11
Fayetteville NC 2014,2014,Metropolitan Statistical Area,,,377939,320,6560,2667,3893,1513,-5089,-3576,3
Fayetteville-Springdale-Rogers AR-MO 2014,2014,Metropolitan Statistical Area,,,501653,9278,7178,3292,3886,1447,3970,5417,-25
Flagstaff AZ 2014,2014,Metropolitan Statistical Area,,,137682,992,1697,772,925,124,-124,0,67
Flint MI 2014,2014,Metropolitan Statistical Area,,,412895,-2728,4904,4371,533,255,-3303,-3048,-213
Florence SC 2014,2014,Metropolitan Statistical Area,,,207030,650,2585,2254,331,133,246,379,-60
Florence-Muscle Shoals AL 2014,2014,Metropolitan Statistical Area,,,147639,366,1527,1739,-212,93,549,642,-64
Fond du Lac WI 2014,2014,Metropolitan Statistical Area,,,101759,111,1089,870,219,85,-148,-63,-45
Fort Collins CO 2014,2014,Metropolitan Statistical Area,,,324122,7628,3447,1965,1482,411,5481,5892,254
Fort Smith AR-OK 2014,2014,Metropolitan Statistical Area,,,279592,-338,3627,2938,689,153,-1113,-960,-67
Fort Wayne IN 2014,2014,Metropolitan Statistical Area,,,427183,2613,6003,3485,2518,851,-578,273,-178
Fresno CA 2014,2014,Metropolitan Statistical Area,,,965974,9872,15977,6721,9256,2152,-1331,821,-205
Gadsden AL 2014,2014,Metropolitan Statistical Area,,,103531,-431,1144,1431,-287,63,-190,-127,-17
Gainesville FL 2014,2014,Metropolitan Statistical Area,,,273377,3161,3060,2021,1039,1362,688,2050,72
Gainesville GA 2014,2014,Metropolitan Statistical Area,,,190761,3002,2494,1367,1127,290,1370,1660,215
Gettysburg PA 2014,2014,Metropolitan Statistical Area,,,101714,257,974,931,43,59,118,177,37
Glens Falls NY 2014,2014,Metropolitan Statistical Area,,,127345,-553,1169,1303,-134,49,-408,-359,-60
Goldsboro NC 2014,2014,Metropolitan Statistical Area,,,124456,-140,1749,1217,532,304,-952,-648,-24
Grand Forks ND-MN 2014,2014,Metropolitan Statistical Area,,,101842,828,1418,797,621,333,-104,229,-22
Grand Island NE 2014,2014,Metropolitan Statistical Area,,,84755,568,1195,712,483,353,-267,86,-1
Grand Junction CO 2014,2014,Metropolitan Statistical Area,,,148255,556,1825,1356,469,67,-17,50,37
Grand Rapids-Wyoming MI 2014,2014,Metropolitan Statistical Area,,,1027703,10456,13817,7274,6543,1548,2540,4088,-175
Grants Pass OR 2014,2014,Metropolitan Statistical Area,,,83599,328,826,1119,-293,7,659,666,-45
Great Falls MT 2014,2014,Metropolitan Statistical Area,,,82344,-60,1169,763,406,134,-540,-406,-60
Greeley CO 2014,2014,Metropolitan Statistical Area,,,277670,7110,3980,1546,2434,319,4258,4577,99
Green Bay WI 2014,2014,Metropolitan Statistical Area,,,314531,1958,3945,2238,1707,414,-20,394,-143
Greensboro-High Point NC 2014,2014,Metropolitan Statistical Area,,,746593,5279,8750,6631,2119,1665,1706,3371,-211
Greenville NC 2014,2014,Metropolitan Statistical Area,,,175354,1003,2136,1227,909,229,-140,89,5
Greenville-Anderson-Mauldin SC 2014,2014,Metropolitan Statistical Area,,,862463,12057,10342,7795,2547,1515,7747,9262,248
Gulfport-Biloxi-Pascagoula MS 2014,2014,Metropolitan Statistical Area,,,386144,3686,4741,3413,1328,650,1743,2393,-35
Hagerstown-Martinsburg MD-WV 2014,2014,Metropolitan Statistical Area,,,260070,2120,3164,2425,739,301,1115,1416,-35
Hammond LA 2014,2014,Metropolitan Statistical Area,,,127049,1541,1937,1211,726,114,688,802,13
Hanford-Corcoran CA 2014,2014,Metropolitan Statistical Area,,,150269,-593,2345,818,1527,359,-2504,-2145,25
Harrisburg-Carlisle PA 2014,2014,Metropolitan Statistical Area,,,560849,2943,6537,4993,1544,1454,112,1566,-167
Harrisonburg VA 2014,2014,Metropolitan Statistical Area,,,130649,1416,1411,921,490,448,420,868,58
Hartford-West Hartford-East Hartford CT 2014,2014,Metropolitan Statistical Area,,,1214295,-1648,12059,10289,1770,5504,-8591,-3087,-331
Hattiesburg MS 2014,2014,Metropolitan Statistical Area,,,148656,810,2044,1176,868,113,-178,-65,7
Hickory-Lenoir-Morganton NC 2014,2014,Metropolitan Statistical Area,,,362896,-477,3796,3748,48,297,-785,-488,-37
Hilton Head Island-Bluffton-Beaufort SC 2014,2014,Metropolitan Statistical Area,,,203022,4743,2386,1622,764,620,2919,3539,440
Hinesville GA 2014,2014,Metropolitan Statistical Area,,,82311,1613,1672,391,1281,358,-51,307,25
Homosassa Springs FL 2014,2014,Metropolitan Statistical Area,,,139377,243,1009,2410,-1401,90,1449,1539,105
Hot Springs AR 2014,2014,Metropolitan Statistical Area,,,97322,257,1141,1288,-147,18,432,450,-46
Houma-Thibodaux LA 2014,2014,Metropolitan Statistical Area,,,211348,1385,2755,1862,893,272,310,582,-90
Houston-The Woodlands-Sugar Land TX 2014,2014,Metropolitan Statistical Area,,,6490180,156371,94872,37096,57776,32283,65850,98133,462
Huntington-Ashland WV-KY-OH 2014,2014,Metropolitan Statistical Area,,,363325,-864,4127,4154,-27,161,-876,-715,-122
Huntsville AL 2014,2014,Metropolitan Statistical Area,,,441086,5089,5033,3495,1538,665,2783,3448,103
Idaho Falls ID 2014,2014,Metropolitan Statistical Area,,,138266,1220,2467,915,1552,60,-410,-350,18
Indianapolis-Carmel-Anderson IN 2014,2014,Metropolitan Statistical Area,,,1971274,18128,26630,15200,11430,4370,2234,6604,94
Iowa City IA 2014,2014,Metropolitan Statistical Area,,,164357,2528,2121,896,1225,910,395,1305,-2
Ithaca NY 2014,2014,Metropolitan Statistical Area,,,104691,323,948,599,349,1104,-1098,6,-32
Jackson MI 2014,2014,Metropolitan Statistical Area,,,159741,-168,1756,1592,164,111,-351,-240,-92
Jackson MS 2014,2014,Metropolitan Statistical Area,,,577564,345,7413,5069,2344,527,-2764,-2237,238
Jackson TN 2014,2014,Metropolitan Statistical Area,,,130225,-493,1658,1230,428,80,-963,-883,-38
Jacksonville FL 2014,2014,Metropolitan Statistical Area,,,1419127,23081,17664,12192,5472,3715,12892,16607,1002
Jacksonville NC 2014,2014,Metropolitan Statistical Area,,,187589,1920,4327,937,3390,906,-2438,-1532,62
Janesville-Beloit WI 2014,2014,Metropolitan Statistical Area,,,161188,555,1901,1371,530,54,42,96,-71
Jefferson City MO 2014,2014,Metropolitan Statistical Area,,,150866,228,1804,1259,545,150,-426,-276,-41
Johnson City TN 2014,2014,Metropolitan Statistical Area,,,201091,122,2056,2159,-103,113,174,287,-62
Johnstown PA 2014,2014,Metropolitan Statistical Area,,,137732,-1168,1300,1771,-471,63,-669,-606,-91
Jonesboro AR 2014,2014,Metropolitan Statistical Area,,,126764,895,1752,1218,534,139,266,405,-44
Joplin MO 2014,2014,Metropolitan Statistical Area,,,176141,932,2451,1687,764,172,58,230,-62
Kahului-Wailuku-Lahaina HI 2014,2014,Metropolitan Statistical Area,,,163108,2228,2046,1253,793,711,807,1518,-83
Kalamazoo-Portage MI 2014,2014,Metropolitan Statistical Area,,,334017,1460,4094,2811,1283,607,-297,310,-133
Kankakee IL 2014,2014,Metropolitan Statistical Area,,,111375,-818,1305,1091,214,86,-1112,-1026,-6
Kansas City MO-KS 2014,2014,Metropolitan Statistical Area,,,2071133,15782,27732,16321,11411,3605,1089,4694,-323
Kennewick-Richland WA 2014,2014,Metropolitan Statistical Area,,,274295,3228,4196,1680,2516,363,340,703,9
Killeen-Temple TX 2014,2014,Metropolitan Statistical Area,,,424858,1576,7393,2544,4849,1624,-4976,-3352,79
Kingsport-Bristol-Bristol TN-VA 2014,2014,Metropolitan Statistical Area,,,308079,-277,3077,3617,-540,64,416,480,-217
Kingston NY 2014,2014,Metropolitan Statistical Area,,,180445,-403,1562,1637,-75,356,-578,-222,-106
Knoxville TN 2014,2014,Metropolitan Statistical Area,,,857585,5634,9487,8582,905,787,4032,4819,-90
Kokomo IN 2014,2014,Metropolitan Statistical Area,,,82982,21,1031,903,128,80,-155,-75,-32
La Crosse-Onalaska WI-MN 2014,2014,Metropolitan Statistical Area,,,136749,593,1420,1128,292,156,154,310,-9
Lafayette LA 2014,2014,Metropolitan Statistical Area,,,484974,5211,6776,4138,2638,801,1781,2582,-9
Lafayette-West Lafayette IN 2014,2014,Metropolitan Statistical Area,,,211697,1928,2667,1343,1324,1405,-738,667,-63
Lake Charles LA 2014,2014,Metropolitan Statistical Area,,,203883,1422,2821,1951,870,234,384,618,-66
Lake Havasu City-Kingman AZ 2014,2014,Metropolitan Statistical Area,,,203361,506,1857,2799,-942,12,1104,1116,332
Lakeland-Winter Haven FL 2014,2014,Metropolitan Statistical Area,,,634638,11479,7268,6215,1053,2675,7436,10111,315
Lancaster PA 2014,2014,Metropolitan Statistical Area,,,533320,3198,7067,4774,2293,1213,-304,909,-4
Lansing-East Lansing MI 2014,2014,Metropolitan Statistical Area,,,470458,2110,5200,3635,1565,2112,-1438,674,-129
Laredo TX 2014,2014,Metropolitan Statistical Area,,,266673,2901,5457,1211,4246,719,-1984,-1265,-80
Las Cruces NM 2014,2014,Metropolitan Statistical Area,,,213676,-21,2950,1506,1444,147,-1644,-1497,32
Las Vegas-Henderson-Paradise NV 2014,2014,Metropolitan Statistical Area,,,2069681,40365,26178,14963,11215,7381,20261,27642,1508
Lawrence KS 2014,2014,Metropolitan Statistical Area,,,116585,1782,1269,605,664,621,523,1144,-26
Lawton OK 2014,2014,Metropolitan Statistical Area,,,131183,-5,1946,1102,844,410,-1252,-842,-7
Lebanon PA 2014,2014,Metropolitan Statistical Area,,,136359,652,1630,1424,206,394,52,446,0
Lewiston ID-WA 2014,2014,Metropolitan Statistical Area,,,62196,154,752,700,52,35,93,128,-26
Lewiston-Auburn ME 2014,2014,Metropolitan Statistical Area,,,107440,49,1273,992,281,118,-310,-192,-40
Lexington-Fayette KY 2014,2014,Metropolitan Statistical Area,,,494189,4865,6247,3570,2677,1292,1010,2302,-114
Lima OH 2014,2014,Metropolitan Statistical Area,,,105040,-174,1288,1063,225,59,-416,-357,-42
Lincoln NE 2014,2014,Metropolitan Statistical Area,,,318945,4596,4243,2028,2215,897,1455,2352,29
Little Rock-North Little Rock-Conway AR 2014,2014,Metropolitan Statistical Area,,,729135,4800,9788,6215,3573,939,454,1393,-166
Logan UT-ID 2014,2014,Metropolitan Statistical Area,,,131364,1189,2573,574,1999,331,-1169,-838,28
Longview TX 2014,2014,Metropolitan Statistical Area,,,217481,524,3022,2190,832,285,-541,-256,-52
Longview WA 2014,2014,Metropolitan Statistical Area,,,102133,404,1135,1051,84,24,347,371,-51
Los Angeles-Long Beach-Anaheim CA 2014,2014,Metropolitan Statistical Area,,,13262220,86371,169963,82136,87827,65972,-61449,4523,-5979
Anaheim-Santa Ana-Irvine CA 2014,2014,Metropolitan Division,,,3145515,23661,38295,19073,19222,13400,-7945,5455,-1016
Los Angeles-Long Beach-Glendale CA 2014,2014,Metropolitan Division,,,10116705,62710,131668,63063,68605,52572,-53504,-932,-4963
Louisville/Jefferson County KY-IN 2014,2014,Metropolitan Statistical Area,,,1269702,7458,15635,11440,4195,2334,1499,3833,-570
Lubbock TX 2014,2014,Metropolitan Statistical Area,,,305644,3884,4169,2440,1729,456,1655,2111,44
Lynchburg VA 2014,2014,Metropolitan Statistical Area,,,257835,1111,2737,2509,228,383,506,889,-6
Macon GA 2014,2014,Metropolitan Statistical Area,,,230450,-882,2946,2465,481,201,-1548,-1347,-16
Madera CA 2014,2014,Metropolitan Statistical Area,,,154548,2383,2224,960,1264,207,939,1146,-27
Madison WI 2014,2014,Metropolitan Statistical Area,,,633787,6321,7438,4030,3408,1671,1368,3039,-126
Manchester-Nashua NH 2014,2014,Metropolitan Statistical Area,,,405184,1786,4241,3036,1205,1001,-286,715,-134
Manhattan KS 2014,2014,Metropolitan Statistical Area,,,98091,-484,1521,499,1022,745,-2278,-1533,27
Mankato-North Mankato MN 2014,2014,Metropolitan Statistical Area,,,98478,760,1092,678,414,107,251,358,-12
Mansfield OH 2014,2014,Metropolitan Statistical Area,,,121942,-350,1413,1313,100,22,-391,-369,-81
McAllen-Edinburg-Mission TX 2014,2014,Metropolitan Statistical Area,,,831073,12131,16120,4060,12060,1945,-1972,-27,98
Medford OR 2014,2014,Metropolitan Statistical Area,,,210287,2196,2316,2172,144,79,1789,1868,184
Memphis TN-MS-AR 2014,2014,Metropolitan Statistical Area,,,1343230,1520,18801,11601,7200,1828,-7394,-5566,-114
Merced CA 2014,2014,Metropolitan Statistical Area,,,266353,2872,4267,1625,2642,558,-185,373,-143
Miami-Fort Lauderdale-West Palm Beach FL 2014,2014,Metropolitan Statistical Area,,,5929819,66361,65943,49224,16719,62255,-12526,49729,-87
Fort Lauderdale-Pompano Beach-Deerfield Beach FL 2014,2014,Metropolitan Division,,,1869235,23842,21354,15069,6285,15486,2372,17858,-301
Miami-Miami Beach-Kendall FL 2014,2014,Metropolitan Division,,,2662874,21008,30445,19975,10470,38734,-27175,11559,-1021
West Palm Beach-Boca Raton-Delray Beach FL 2014,2014,Metropolitan Division,,,1397710,21511,14144,14180,-36,8035,12277,20312,1235
Michigan City-La Porte IN 2014,2014,Metropolitan Statistical Area,,,111444,188,1280,1172,108,16,96,112,-32
Midland MI 2014,2014,Metropolitan Statistical Area,,,83427,-166,831,694,137,142,-436,-294,-9
Midland TX 2014,2014,Metropolitan Statistical Area,,,161290,4050,2807,1080,1727,112,2086,2198,125
Milwaukee-Waukesha-West Allis WI 2014,2014,Metropolitan Statistical Area,,,1572245,2078,19882,13059,6823,2521,-7117,-4596,-149
Minneapolis-St. Paul-Bloomington MN-WI 2014,2014,Metropolitan Statistical Area,,,3495176,33742,45934,21854,24080,11544,-782,10762,-1100
Missoula MT 2014,2014,Metropolitan Statistical Area,,,112684,915,1219,794,425,119,386,505,-15
Mobile AL 2014,2014,Metropolitan Statistical Area,,,415123,563,5501,4290,1211,683,-1143,-460,-188
Modesto CA 2014,2014,Metropolitan Statistical Area,,,531997,5711,7550,3747,3803,1366,636,2002,-94
Monroe LA 2014,2014,Metropolitan Statistical Area,,,178864,246,2521,1791,730,171,-665,-494,10
Monroe MI 2014,2014,Metropolitan Statistical Area,,,149824,-355,1453,1361,92,74,-432,-358,-89
Montgomery AL 2014,2014,Metropolitan Statistical Area,,,373141,-804,4705,3455,1250,520,-2511,-1991,-63
Morgantown WV 2014,2014,Metropolitan Statistical Area,,,137251,1326,1391,989,402,348,583,931,-7
Morristown TN 2014,2014,Metropolitan Statistical Area,,,115713,339,1296,1273,23,88,225,313,3
Mount Vernon-Anacortes WA 2014,2014,Metropolitan Statistical Area,,,120365,1623,1458,1116,342,126,1046,1172,109
Muncie IN 2014,2014,Metropolitan Statistical Area,,,117074,-281,1226,1159,67,132,-398,-266,-82
Muskegon MI 2014,2014,Metropolitan Statistical Area,,,172344,98,2100,1666,434,85,-348,-263,-73
Myrtle Beach-Conway-North Myrtle Beach SC-NC 2014,2014,Metropolitan Statistical Area,,,417668,12879,4105,4178,-73,459,10977,11436,1516
Napa CA 2014,2014,Metropolitan Statistical Area,,,141667,1087,1446,1241,205,487,424,911,-29
Naples-Immokalee-Marco Island FL 2014,2014,Metropolitan Statistical Area,,,348777,8671,3187,3156,31,2189,5514,7703,937
Nashville-Davidson--Murfreesboro--Franklin TN 2014,2014,Metropolitan Statistical Area,,,1792649,34072,22977,13580,9397,4039,19883,23922,753
New Bern NC 2014,2014,Metropolitan Statistical Area,,,127534,-55,1700,1237,463,358,-861,-503,-15
New Haven-Milford CT 2014,2014,Metropolitan Statistical Area,,,861277,-1739,8974,7625,1349,3728,-6725,-2997,-91
New Orleans-Metairie LA 2014,2014,Metropolitan Statistical Area,,,1251849,9900,15639,10968,4671,3245,2010,5255,-26
New York-Newark-Jersey City NY-NJ-PA 2014,2014,Metropolitan Statistical Area,,,20092883,90797,251368,146346,105022,146892,-162903,-16011,1786
Dutchess County-Putnam County NY 2014,2014,Metropolitan Division,,,396066,-640,3528,3156,372,1124,-2054,-930,-82
Nassau County-Suffolk County NY 2014,2014,Metropolitan Division,,,2861595,3543,29634,23117,6517,9246,-10908,-1662,-1312
Newark NJ-PA 2014,2014,Metropolitan Division,,,2508124,6514,27913,18535,9378,14427,-17121,-2694,-170
New York-Jersey City-White Plains NY-NJ 2014,2014,Metropolitan Division,,,14327098,81380,190293,101538,88755,122095,-132820,-10725,3350
Niles-Benton Harbor MI 2014,2014,Metropolitan Statistical Area,,,155233,-88,1823,1610,213,336,-529,-193,-108
North Port-Sarasota-Bradenton FL 2014,2014,Metropolitan Statistical Area,,,748708,16049,6364,8928,-2564,1945,14595,16540,2073
Norwich-New London CT 2014,2014,Metropolitan Statistical Area,,,273676,-300,2761,2361,400,1212,-1831,-619,-81
Ocala FL 2014,2014,Metropolitan Statistical Area,,,339167,3008,3268,4566,-1298,615,3495,4110,196
Ocean City NJ 2014,2014,Metropolitan Statistical Area,,,95344,-505,903,1284,-381,186,-217,-31,-93
Odessa TX 2014,2014,Metropolitan Statistical Area,,,153904,4382,2911,1177,1734,52,2544,2596,52
Ogden-Clearfield UT 2014,2014,Metropolitan Statistical Area,,,632293,10055,10795,3373,7422,717,2104,2821,-188
Oklahoma City OK 2014,2014,Metropolitan Statistical Area,,,1336767,16182,18985,10887,8098,2718,5618,8336,-252
Olympia-Tumwater WA 2014,2014,Metropolitan Statistical Area,,,265851,3290,3157,2010,1147,642,1467,2109,34
Omaha-Council Bluffs NE-IA 2014,2014,Metropolitan Statistical Area,,,904421,8848,13193,6312,6881,1922,319,2241,-274
Orlando-Kissimmee-Sanford FL 2014,2014,Metropolitan Statistical Area,,,2321418,50335,27574,16439,11135,15044,22893,37937,1263
Oshkosh-Neenah WI 2014,2014,Metropolitan Statistical Area,,,169511,151,1883,1406,477,84,-404,-320,-6
Owensboro KY 2014,2014,Metropolitan Statistical Area,,,116506,107,1557,1177,380,46,-270,-224,-49
Oxnard-Thousand Oaks-Ventura CA 2014,2014,Metropolitan Statistical Area,,,846178,5206,10602,5597,5005,1840,-1530,310,-109
Palm Bay-Melbourne-Titusville FL 2014,2014,Metropolitan Statistical Area,,,556885,5445,5043,6512,-1469,1167,5098,6265,649
Panama City FL 2014,2014,Metropolitan Statistical Area,,,194929,4158,2424,1951,473,312,3194,3506,179
Parkersburg-Vienna WV 2014,2014,Metropolitan Statistical Area,,,92082,-193,941,1081,-140,15,-13,2,-55
Pensacola-Ferry Pass-Brent FL 2014,2014,Metropolitan Statistical Area,,,474081,5399,5750,4605,1145,1064,3020,4084,170
Peoria IL 2014,2014,Metropolitan Statistical Area,,,380040,-2039,4922,3730,1192,416,-3671,-3255,24
Philadelphia-Camden-Wilmington PA-NJ-DE-MD 2014,2014,Metropolitan Statistical Area,,,6051170,14942,72217,54179,18038,19564,-20732,-1168,-1928
Camden NJ 2014,2014,Metropolitan Division,,,1251711,-495,13701,10936,2765,2988,-5636,-2648,-612
Montgomery County-Bucks County-Chester County PA 2014,2014,Metropolitan Division,,,1956326,6538,20258,16945,3313,4499,-586,3913,-688
Philadelphia PA 2014,2014,Metropolitan Division,,,2123257,5361,29814,20269,9545,10262,-14212,-3950,-234
Wilmington DE-MD-NJ 2014,2014,Metropolitan Division,,,719876,3538,8444,6029,2415,1815,-298,1517,-394
Phoenix-Mesa-Scottsdale AZ 2014,2014,Metropolitan Statistical Area,,,4489109,84980,59914,30617,29297,10716,41127,51843,3840
Pine Bluff AR 2014,2014,Metropolitan Statistical Area,,,94716,-973,1109,1065,44,8,-1039,-1031,14
Pittsburgh PA 2014,2014,Metropolitan Statistical Area,,,2355968,-4597,23838,27282,-3444,3217,-2806,411,-1564
Pittsfield MA 2014,2014,Metropolitan Statistical Area,,,128715,-774,1108,1426,-318,200,-544,-344,-112
Pocatello ID 2014,2014,Metropolitan Statistical Area,,,83347,25,1261,629,632,87,-652,-565,-42
Portland-South Portland ME 2014,2014,Metropolitan Statistical Area,,,523552,3189,4983,4693,290,807,1915,2722,177
Portland-Vancouver-Hillsboro OR-WA 2014,2014,Metropolitan Statistical Area,,,2348247,33500,27739,16578,11161,5583,16329,21912,427
Port St. Lucie FL 2014,2014,Metropolitan Statistical Area,,,444420,6635,4110,4899,-789,992,5664,6656,768
Prescott AZ 2014,2014,Metropolitan Statistical Area,,,218844,3455,1821,2647,-826,161,3828,3989,292
Providence-Warwick RI-MA 2014,2014,Metropolitan Statistical Area,,,1609367,3846,16585,14642,1943,5175,-2518,2657,-754
Provo-Orem UT 2014,2014,Metropolitan Statistical Area,,,571460,9207,12144,2132,10012,863,-1654,-791,-14
Pueblo CO 2014,2014,Metropolitan Statistical Area,,,161875,555,1908,1638,270,65,247,312,-27
Punta Gorda FL 2014,2014,Metropolitan Statistical Area,,,168474,3526,1037,2420,-1383,277,4009,4286,623
Racine WI 2014,2014,Metropolitan Statistical Area,,,195163,241,2369,1567,802,159,-626,-467,-94
Raleigh NC 2014,2014,Metropolitan Statistical Area,,,1242974,27675,15437,6832,8605,4194,14337,18531,539
Rapid City SD 2014,2014,Metropolitan Statistical Area,,,143638,2275,1963,1048,915,127,1128,1255,105
Reading PA 2014,2014,Metropolitan Statistical Area,,,413691,39,4838,3692,1146,1198,-2036,-838,-269
Redding CA 2014,2014,Metropolitan Statistical Area,,,179804,667,2107,2058,49,228,402,630,-12
Reno NV 2014,2014,Metropolitan Statistical Area,,,443990,6277,5354,3540,1814,796,3372,4168,295
Richmond VA 2014,2014,Metropolitan Statistical Area,,,1260029,13162,14932,10076,4856,3616,4444,8060,246
Riverside-San Bernardino-Ontario CA 2014,2014,Metropolitan Statistical Area,,,4441890,51628,61427,29192,32235,8654,10359,19013,380
Roanoke VA 2014,2014,Metropolitan Statistical Area,,,313388,984,3409,3330,79,715,308,1023,-118
Rochester MN 2014,2014,Metropolitan Statistical Area,,,212778,940,2812,1479,1333,663,-995,-332,-61
Rochester NY 2014,2014,Metropolitan Statistical Area,,,1083393,-701,11602,9405,2197,3058,-5631,-2573,-325
Rockford IL 2014,2014,Metropolitan Statistical Area,,,342411,-2344,4084,3001,1083,371,-3754,-3383,-44
Rocky Mount NC 2014,2014,Metropolitan Statistical Area,,,149290,-824,1741,1584,157,65,-1012,-947,-34
Rome GA 2014,2014,Metropolitan Statistical Area,,,96063,38,1125,1032,93,116,-128,-12,-43
Sacramento--Roseville--Arden-Arcade CA 2014,2014,Metropolitan Statistical Area,,,2244397,26882,27409,16596,10813,7433,8155,15588,481
Saginaw MI 2014,2014,Metropolitan Statistical Area,,,195012,-1648,2259,2018,241,168,-1958,-1790,-99
St. Cloud MN 2014,2014,Metropolitan Statistical Area,,,192418,1070,2384,1185,1199,248,-295,-47,-82
St. George UT 2014,2014,Metropolitan Statistical Area,,,151948,4229,2188,1094,1094,69,2655,2724,411
St. Joseph MO-KS 2014,2014,Metropolitan Statistical Area,,,127431,-348,1537,1208,329,175,-799,-624,-53
St. Louis MO-IL 2014,2014,Metropolitan Statistical Area,,,2806207,4620,33623,25458,8165,4482,-7748,-3266,-279
Salem OR 2014,2014,Metropolitan Statistical Area,,,404026,5180,5181,3312,1869,481,2517,2998,313
Salinas CA 2014,2014,Metropolitan Statistical Area,,,431344,2221,6613,2450,4163,1141,-2974,-1833,-109
Salisbury MD-DE 2014,2014,Metropolitan Statistical Area,,,389922,4782,4222,4215,7,955,3382,4337,438
Salt Lake City UT 2014,2014,Metropolitan Statistical Area,,,1153340,11756,19072,6310,12762,3209,-3704,-495,-511
San Angelo TX 2014,2014,Metropolitan Statistical Area,,,118182,1618,1550,1017,533,169,959,1128,-43
San Antonio-New Braunfels TX 2014,2014,Metropolitan Statistical Area,,,2328652,46451,32280,16050,16230,4855,24818,29673,548
San Diego-Carlsbad CA 2014,2014,Metropolitan Statistical Area,,,3263431,40873,44860,21128,23732,14637,2549,17186,-45
San Francisco-Oakland-Hayward CA 2014,2014,Metropolitan Statistical Area,,,4594060,64406,52901,30528,22373,28616,14592,43208,-1175
Oakland-Hayward-Berkeley CA 2014,2014,Metropolitan Division,,,2722260,43054,32210,17771,14439,15420,14135,29555,-940
San Francisco-Redwood City-South San Francisco CA 2014,2014,Metropolitan Division,,,1611050,19423,18435,10924,7511,12272,-267,12005,-93
San Rafael CA 2014,2014,Metropolitan Division,,,260750,1929,2256,1833,423,924,724,1648,-142
San Jose-Sunnyvale-Santa Clara CA 2014,2014,Metropolitan Statistical Area,,,1952872,24171,25083,10543,14540,17454,-7168,10286,-655
San Luis Obispo-Paso Robles-Arroyo Grande CA 2014,2014,Metropolitan Statistical Area,,,279083,2799,2610,2199,411,245,2022,2267,121
Santa Cruz-Watsonville CA 2014,2014,Metropolitan Statistical Area,,,271804,2360,3105,1804,1301,427,678,1105,-46
Santa Fe NM 2014,2014,Metropolitan Statistical Area,,,148164,858,1356,1041,315,421,116,537,6
Santa Maria-Santa Barbara CA 2014,2014,Metropolitan Statistical Area,,,440668,4592,5636,3013,2623,1420,628,2048,-79
Santa Rosa CA 2014,2014,Metropolitan Statistical Area,,,500292,4860,5196,4115,1081,701,2859,3560,219
Savannah GA 2014,2014,Metropolitan Statistical Area,,,372708,6659,5246,2924,2322,903,3352,4255,82
Scranton--Wilkes-Barre--Hazleton PA 2014,2014,Metropolitan Statistical Area,,,559679,-2159,5486,6891,-1405,1130,-1433,-303,-451
Seattle-Tacoma-Bellevue WA 2014,2014,Metropolitan Statistical Area,,,3671478,57857,46315,24262,22053,18925,17400,36325,-521
Seattle-Bellevue-Everett WA 2014,2014,Metropolitan Division,,,2839550,46148,35024,17880,17144,16660,13064,29724,-720
Tacoma-Lakewood WA 2014,2014,Metropolitan Division,,,831928,11709,11291,6382,4909,2265,4336,6601,199
Sebastian-Vero Beach FL 2014,2014,Metropolitan Statistical Area,,,144755,2734,1256,1887,-631,256,2501,2757,608
Sebring FL 2014,2014,Metropolitan Statistical Area,,,98236,317,881,1442,-561,223,596,819,59
Sheboygan WI 2014,2014,Metropolitan Statistical Area,,,115290,422,1260,1048,212,100,127,227,-17
Sherman-Denison TX 2014,2014,Metropolitan Statistical Area,,,123534,1191,1497,1290,207,145,841,986,-2
Shreveport-Bossier City LA 2014,2014,Metropolitan Statistical Area,,,445142,-1683,6426,4450,1976,477,-4108,-3631,-28
Sierra Vista-Douglas AZ 2014,2014,Metropolitan Statistical Area,,,127448,-2296,1622,1205,417,295,-2987,-2692,-21
Sioux City IA-NE-SD 2014,2014,Metropolitan Statistical Area,,,168806,21,2388,1383,1005,294,-1206,-912,-72
Sioux Falls SD 2014,2014,Metropolitan Statistical Area,,,248351,4729,3870,1634,2236,752,1646,2398,95
South Bend-Mishawaka IN-MI 2014,2014,Metropolitan Statistical Area,,,319226,694,3969,2930,1039,532,-729,-197,-148
Spartanburg SC 2014,2014,Metropolitan Statistical Area,,,321418,2618,3883,3209,674,213,1756,1969,-25
Spokane-Spokane Valley WA 2014,2014,Metropolitan Statistical Area,,,540953,5269,6615,4861,1754,787,2585,3372,143
Springfield IL 2014,2014,Metropolitan Statistical Area,,,211567,-78,2420,2157,263,179,-490,-311,-30
Springfield MA 2014,2014,Metropolitan Statistical Area,,,629100,716,6554,5510,1044,3416,-3546,-130,-198
Springfield MO 2014,2014,Metropolitan Statistical Area,,,452297,3445,5642,3996,1646,340,1405,1745,54
Springfield OH 2014,2014,Metropolitan Statistical Area,,,136554,-249,1567,1631,-64,64,-198,-134,-51
State College PA 2014,2014,Metropolitan Statistical Area,,,158742,895,1325,979,346,878,-271,607,-58
Staunton-Waynesboro VA 2014,2014,Metropolitan Statistical Area,,,119766,363,1241,1222,19,53,282,335,9
Stockton-Lodi CA 2014,2014,Metropolitan Statistical Area,,,715597,10570,10078,5074,5004,1771,3789,5560,6
Sumter SC 2014,2014,Metropolitan Statistical Area,,,107919,-83,1529,1006,523,137,-701,-564,-42
Syracuse NY 2014,2014,Metropolitan Statistical Area,,,661478,-1383,7394,5693,1701,1773,-4565,-2792,-292
Tallahassee FL 2014,2014,Metropolitan Statistical Area,,,375751,2168,3908,2615,1293,835,99,934,-59
Tampa-St. Petersburg-Clearwater FL 2014,2014,Metropolitan Statistical Area,,,2915582,41428,31260,30593,667,11025,28372,39397,1364
Terre Haute IN 2014,2014,Metropolitan Statistical Area,,,171480,-721,1959,1799,160,204,-1099,-895,14
Texarkana TX-AR 2014,2014,Metropolitan Statistical Area,,,149235,-328,1970,1559,411,47,-749,-702,-37
The Villages FL 2014,2014,Metropolitan Statistical Area,,,114350,5867,479,1439,-960,73,5058,5131,1696
Toledo OH 2014,2014,Metropolitan Statistical Area,,,607456,-974,7569,5787,1782,722,-3317,-2595,-161
Topeka KS 2014,2014,Metropolitan Statistical Area,,,233758,-136,3005,2231,774,166,-1045,-879,-31
Trenton NJ 2014,2014,Metropolitan Statistical Area,,,371537,485,4278,2862,1416,2557,-3413,-856,-75
Tucson AZ 2014,2014,Metropolitan Statistical Area,,,1004516,6466,11980,9087,2893,2260,861,3121,452
Tulsa OK 2014,2014,Metropolitan Statistical Area,,,969224,6800,13245,9183,4062,1182,1850,3032,-294
Tuscaloosa AL 2014,2014,Metropolitan Statistical Area,,,237761,2323,2885,2095,790,266,1316,1582,-49
Tyler TX 2014,2014,Metropolitan Statistical Area,,,218842,2172,3005,1951,1054,263,840,1103,15
Urban Honolulu HI 2014,2014,Metropolitan Statistical Area,,,991788,4769,13743,7869,5874,6702,-7336,-634,-471
Utica-Rome NY 2014,2014,Metropolitan Statistical Area,,,296615,-1432,3219,3112,107,774,-2165,-1391,-148
Valdosta GA 2014,2014,Metropolitan Statistical Area,,,143317,489,1982,1165,817,207,-603,-396,68
Vallejo-Fairfield CA 2014,2014,Metropolitan Statistical Area,,,431131,5912,5151,3175,1976,1523,2291,3814,122
Victoria TX 2014,2014,Metropolitan Statistical Area,,,98630,1038,1393,834,559,87,390,477,2
Vineland-Bridgeton NJ 2014,2014,Metropolitan Statistical Area,,,157389,236,2063,1437,626,504,-813,-309,-81
Virginia Beach-Norfolk-Newport News VA-NC 2014,2014,Metropolitan Statistical Area,,,1716624,9239,22826,13559,9267,5156,-5082,74,-102
Visalia-Porterville CA 2014,2014,Metropolitan Statistical Area,,,458198,3473,8019,2862,5157,439,-1916,-1477,-207
Waco TX 2014,2014,Metropolitan Statistical Area,,,260430,1331,3644,2203,1441,292,-308,-16,-94
Walla Walla WA 2014,2014,Metropolitan Statistical Area,,,63829,156,723,611,112,79,-56,23,21
Warner Robins GA 2014,2014,Metropolitan Statistical Area,,,187516,1161,2467,1475,992,337,-173,164,5
Washington-Arlington-Alexandria DC-VA-MD-WV 2014,2014,Metropolitan Statistical Area,,,6033737,66561,81330,34180,47150,43070,-24741,18329,1082
Silver Spring-Frederick-Rockville MD 2014,2014,Metropolitan Division,,,1274122,12941,15936,7499,8437,10950,-6189,4761,-257
Washington-Arlington-Alexandria DC-VA-MD-WV 2014,2014,Metropolitan Division,,,4759615,53620,65394,26681,38713,32120,-18552,13568,1339
Waterloo-Cedar Falls IA 2014,2014,Metropolitan Statistical Area,,,169993,514,2072,1510,562,194,-147,47,-95
Watertown-Fort Drum NY 2014,2014,Metropolitan Statistical Area,,,119103,-433,2184,916,1268,520,-2246,-1726,25
Wausau WI 2014,2014,Metropolitan Statistical Area,,,135780,415,1586,1065,521,119,-186,-67,-39
Weirton-Steubenville WV-OH 2014,2014,Metropolitan Statistical Area,,,121336,-606,1122,1667,-545,6,4,10,-71
Wenatchee WA 2014,2014,Metropolitan Statistical Area,,,114392,896,1429,948,481,105,306,411,4
Wheeling WV-OH 2014,2014,Metropolitan Statistical Area,,,145205,-648,1553,1806,-253,41,-343,-302,-93
Wichita KS 2014,2014,Metropolitan Statistical Area,,,641076,2817,9451,5466,3985,972,-2025,-1053,-115
Wichita Falls TX 2014,2014,Metropolitan Statistical Area,,,151536,7,1929,1484,445,353,-785,-432,-6
Williamsport PA 2014,2014,Metropolitan Statistical Area,,,116508,-224,1288,1297,-9,74,-224,-150,-65
Wilmington NC 2014,2014,Metropolitan Statistical Area,,,272548,4247,2874,2240,634,311,3170,3481,132
Winchester VA-WV 2014,2014,Metropolitan Statistical Area,,,133403,1182,1526,1089,437,130,551,681,64
Winston-Salem NC 2014,2014,Metropolitan Statistical Area,,,655015,3495,7458,5983,1475,932,1318,2250,-230
Worcester MA-CT 2014,2014,Metropolitan Statistical Area,,,930473,2423,9938,7745,2193,3719,-2942,777,-547
Yakima WA 2014,2014,Metropolitan Statistical Area,,,247687,390,4052,1938,2114,141,-1787,-1646,-78
York-Hanover PA 2014,2014,Metropolitan Statistical Area,,,440755,1362,4906,3787,1119,592,-53,539,-296
Youngstown-Warren-Boardman OH-PA 2014,2014,Metropolitan Statistical Area,,,553263,-2866,5579,6804,-1225,271,-1548,-1277,-364
Yuba City CA 2014,2014,Metropolitan Statistical Area,,,169813,1165,2477,1211,1266,673,-730,-57,-44
Yuma AZ 2014,2014,Metropolitan Statistical Area,,,203247,1214,3137,1415,1722,471,-1198,-727,219
